a	 a 
abajo	 a b a x o 
abandonaba	 a b a n d o n a b a 
abierta	 a b i e r t a 
abierto	 a b i e r t o 
abiertos	 a b i e r t o s 
abogados	 a b o g a d o s 
abriendo	 a b r i e n d o 
abrigo	 a b r i g o 
abrir	 a b r i r 
abrumador	 a b r u m a d o r 
absoluta	 a b s o l u t a 
absolutamente	 a b s o l u t a m e n t e 
absolutas	 a b s o l u t a s 
absoluto	 a b s o l u t o 
absolutos	 a b s o l u t o s 
abstraccion	 a b s t r a k T i o n 
abstracto	 a b s t r a k t o 
absurda	 a b s u r d a 
abundado	 a b u n d a d o 
abundante	 a b u n d a n t e 
aburrirles	 a b u R i r l e s 
aburro	 a b u R o 
abusar	 a b u s a r 
abusos	 a b u s o s 
aca	a k a
aca	 a k a 
acaba	 a k a b a 
acabado	 a k a b a d o 
acabamos	 a k a b a m o s 
acaban	 a k a b a n 
acabar	 a k a b a r 
acabas	 a k a b a s 
acabo	 a k a b o 
acabo	 a k a b o 
academia	 a k a d e m i a 
academias	 a k a d e m i a s 
academica	 a k a d e m i k a 
academicas	 a k a d e m i k a s 
academico	 a k a d e m i k o 
academicos	 a k a d e m i k o s 
acaso	 a k a s o 
acceder	 a k T e d e r 
accesibilidad	 a k T e s i b i l i d a d 
accesible	 a k T e s i b l e 
acceso	 a k T e s o 
accesos	 a k T e s o s 
access	 a k T e s 
accidentes	 a k T i d e n t e s 
accion	 a k T i o n 
acciones	 a k T i o n e s 
accionistas	 a k T i o n i s t a s 
accuracy	a k i u r a T i
aceleracion	a T e l e r a T i o n
aceleracion	 a T e l e r a T i o n 
acelerado	 a T e l e r a d o 
acelerar	 a T e l e r a r 
acento	 a T e n t o 
aceptacion	 a T e p t a T i o n 
aceptado	 a T e p t a d o 
acerca	 a T e r k a 
acercamiento	 a T e r k a m i e n t o 
acercar	 a T e r k a r 
acercarse	 a T e r k a r s e 
acertados	 a T e r t a d o s 
acertar	 a T e r t a r 
acierto	 a T i e r t o 
aciertos	 a T i e r t o s 
aclaran	 a k l a r a n 
aclarar	 a k l a r a r 
acompaña	 a k o m p a N a 
acompañado	 a k o m p a N a d o 
acompañamos	 a k o m p a N a m o s 
acompañar	 a k o m p a N a r 
acordaba	 a k o r d a b a 
acostumbrado	 a k o s t u m b r a d o 
acostumbrados	 a k o s t u m b r a d o s 
acostumbramos	 a k o s t u m b r a m o s 
acotada	 a k o t a d a 
acotadas	 a k o t a d a s 
acotar	 a k o t a r 
acronimos	 a k r o n i m o s 
actitud	 a k t i t u d 
actitudes	 a k t i t u d e s 
activa	 a k t i b a 
activamente	 a k t i b a m e n t e 
activar	 a k t i b a r 
actividad	 a k t i b i d a d 
actividades	 a k t i b i d a d e s 
activo	 a k t i b o 
activos	 a k t i b o s 
actos	 a k t o s 
actriz	 a k t r i T 
actua	 a k t u a 
actuacion	 a k t u a T i o n 
actual	 a k t u a l 
actuales	 a k t u a l e s 
actualicen	 a k t u a l i T e n 
actualidad	 a k t u a l i d a d 
actualiza	 a k t u a l i T a 
actualizacion	 a k t u a l i T a T i o n 
actualizada	 a k t u a l i T a d a 
actualizado	 a k t u a l i T a d o 
actualizados	 a k t u a l i T a d o s 
actualizar	 a k t u a l i T a r 
actualmente	 a k t u a l m e n t e 
acuden	 a k u d e n 
acudir	 a k u d i r 
acuerda	 a k u e r d a 
acuerdes	 a k u e r d e s 
acuerdo	 a k u e r d o 
acuerdos	 a k u e r d o s 
acumulan	 a k u m u l a n 
ad	 a d 
adapta	 a d a p t a 
adaptacion	 a d a p t a T i o n 
adaptado	 a d a p t a d o 
adaptar	 a d a p t a r 
adecua	 a d e k u a 
adecuada	 a d e k u a d a 
adecuadamente	 a d e k u a d a m e n t e 
adecuado	 a d e k u a d o 
adelantado	 a d e l a n t a d o 
adelantar	 a d e l a n t a r 
adelante	 a d e l a n t e 
adelanto	 a d e l a n t o 
ademas	a d e m a s
ademas	 a d e m a s 
adicional	 a d i T i o n a l 
adicionales	 a d i T i o n a l e s 
adivinar	 a d i b i n a r 
adjuntar	 a d x u n t a r 
administracion	 a d m i n i s t r a T i o n 
administraciones	 a d m i n i s t r a T i o n e s 
administrativa	 a d m i n i s t r a t i b a 
admitiendo	 a d m i t i e n d o 
adolfo	 a d o l f o 
adoptemos	 a d o p t e m o s 
adquiere	 a d k i e r e 
adquirido	 a d k i r i d o 
adquirir	 a d k i r i r 
adquirirlos	 a d k i r i r l o s 
adquisicion	 a d k i s i T i o n 
adrede	 a d r e d e 
afecta	 a f e k t a 
afectados	 a f e k t a d o s 
afectara	 a f e k t a r a 
aficionados	 a f i T i o n a d o s 
afortunadamente	 a f o r t u n a d a m e n t e 
África	 a f r i k a 
ag	 a g 
agapea	 a g a p e a 
agarramos	 a g a R a m o s 
agarrar	 a g a R a r 
agencia	 a x e n T i a 
agencias	 a x e n T i a s 
agenda	 a x e n d a 
agente	 a x e n t e 
agentes	 a x e n t e s 
agil	 a x i l 
agosto	 a g o s t o 
agradecemos	 a g r a d e T e m o s 
agradecer	 a g r a d e T e r 
agradeceros	 a g r a d e T e r o s 
agradecimiento	 a g r a d e T i m i e n t o 
agradecimientos	 a g r a d e T i m i e n t o s 
agradezco	 a g r a d e T k o 
agregado	 a g r e g a d o 
agresivo	 a g r e s i b o 
agronomia	 a g r o n o m i a 
agrupamiento	 a g r u p a m i e n t o 
agua	 a g u a 
aguantando	 a g u a n t a n d o 
aguilera	 a g i l e r a 
aguillo	 a g i y o 
agujeros	 a g u x e r o s 
ah	 a 
ahi	a i
ahi	 a i 
ahora	 a o r a 
ahorrar	 a o R a r 
ahorros	 a o R o s 
aire	 a i r e 
ajenas	 a x e n a s 
ajenos	 a x e n o s 
ajustada	 a x u s t a d a 
ajustado	 a x u s t a d o 
ajustan	 a x u s t a n 
ajuste	 a x u s t e 
aks	a k a e T e
al	 a l 
alargariamos	 a l a r g a r i a m o s 
alarguemos	 a l a r g e m o s 
alcala	 a l k a l a 
alcance	 a l k a n T e 
alcanza	 a l k a n T a 
alcanzara	 a l k a n T a r a 
alcanzar	 a l k a n T a r 
alcanzarnos	 a l k a n T a r n o s 
alcanzo	 a l k a n T o 
alcazar	 a l k a T a r 
alchemist	a l k e m i s t
aldea	 a l d e a 
aleatorio	 a l e a t o r i o 
alemana	 a l e m a n a 
aleman	 a l e m a n 
alemania	 a l e m a n i a 
alergia	 a l e r x i a 
alergias	 a l e r x i a s 
alertas	 a l e r t a s 
alexa	 a l e k s a 
alfabetico	 a l f a b e t i k o 
alfonseca	 a l f o n s e k a 
algo	 a l g o 
algoritmo	 a l g o r i t m o 
algoritmos	 a l g o r i t m o s 
alguien	 a l g i e n 
alguna	 a l g u n a 
algun	a l g u n
algun	 a l g u n 
algunas	 a l g u n a s 
alguno	 a l g u n o 
algunos	 a l g u n o s 
alianza	 a l i a n T a 
alianzas	 a l i a n T a s 
alicante	 a l i k a n t e 
alimentacion	 a l i m e n t a T i o n 
alimentar	 a l i m e n t a r 
alimentarlos	 a l i m e n t a r l o s 
alimentas	 a l i m e n t a s 
alimentos	 a l i m e n t o s 
alimon	 a l i m o n 
alla	a y a
alla	 a y a 
alli	a y i
alli	 a y i 
alltheweb	o l d e g u e b
alma	 a l m a 
almacena	 a l m a T e n a 
almacenada	 a l m a T e n a d a 
almacenado	 a l m a T e n a d o 
almacenan	 a l m a T e n a n 
almacenar	 a l m a T e n a r 
almacenarlas	 a l m a T e n a r l a s 
almacenes	 a l m a T e n e s 
alo	a l o
alo	 a l o 
alquimista	 a l k i m i s t a 
alrededor	 a l R e d e d o r 
alta	 a l t a 
altas	 a l t a s 
altavista	 a l t a b i s t a 
alternativa	 a l t e r n a t i b a 
alternativas	 a l t e r n a t i b a s 
alternativo	 a l t e r n a t i b o 
alto	 a l t o 
altos	 a l t o s 
alucina	 a l u T i n a 
alucino	 a l u T i n o 
alumnos	 a l u m n o s 
amarillas	 a m a r i y a s 
amarillo	 a m a r i y o 
ambicion	 a m b i T i o n 
ambientado	 a m b i e n t a d o 
ambito	 a m b i t o 
ambitos	 a m b i t o s 
ambos	 a m b o s 
america	 a m e r i k a 
americana	 a m e r i k a n a 
americanas	 a m e r i k a n a s 
americano	 a m e r i k a n o 
americanos	 a m e r i k a n o s 
amigacho	 a m i g a C o 
amigo	 a m i g o 
amigos	 a m i g o s 
amplia	 a m p l i a 
amplia	 a m p l i a 
ampliacion	 a m p l i a T i o n 
ampliada	 a m p l i a d a 
ampliado	 a m p l i a d o 
ampliar	 a m p l i a r 
ampliarlas	 a m p l i a r l a s 
amplias	 a m p l i a s 
amplio	 a m p l i o 
ana	 a n a 
añade	 a N a d e 
añadian	 a N a d i a n 
añadido	 a N a d i d o 
añadiendo	 a N a d i e n d o 
añadiendole	 a N a d i e n d o l e 
añadir	 a N a d i r 
añadirle	 a N a d i r l e 
añadirlo	 a N a d i r l o 
analgesico	 a n a l x e s i k o 
analisis	 a n a l i s i s 
analiza	 a n a l i T a 
analizador	 a n a l i T a d o r 
analizamos	 a n a l i T a m o s 
analizan	 a n a l i T a n 
analizando	 a n a l i T a n d o 
analizar	 a n a l i T a r 
analizarla	 a n a l i T a r l a 
analizarse	 a n a l i T a r s e 
analysis	a n a l i s i s
anda	 a n d a 
andalucia	 a n d a l u T i a 
andreas	 a n d r e a s 
android	 a n d r o i d 
anecdota	 a n e k d o t a 
anecdotas	 a n e k d o t a s 
anexa	 a n e k s a 
angloparlantes	 a n g l o p a r l a n t e s 
anima	 a n i m a 
animaciones	 a n i m a T i o n e s 
animados	 a n i m a d o s 
animal	 a n i m a l 
animals	a n i m o l s
animase	 a n i m a s e 
animo	 a n i m o 
año	 a N o 
anonimizarla	 a n o n i m i T a r l a 
años	 a N o s 
anotacion	a n o t a T i o n
anotacion	 a n o t a T i o n 
anotaciones	 a n o t a T i o n e s 
anotada	 a n o t a d a 
anotadas	 a n o t a d a s 
anotados	 a n o t a d o s 
anotan	 a n o t a n 
anotation	a n o t e i C o n
anoto	 a n o t o 
anselmo	 a n s e l m o 
answer	a n s u e r
answering	a n s u e r i n g
ante	 a n t e 
antecedentes	 a n t e T e d e n t e s 
antemano	 a n t e m a n o 
anterior	 a n t e r i o r 
anteriores	 a n t e r i o r e s 
anteriormente	 a n t e r i o r m e n t e 
antes	 a n t e s 
antibiotico	 a n t i b i o t i k o 
antibioticos	 a n t i b i o t i k o s 
anticopia	 a n t i k o p i a 
anticuado	 a n t i k u a d o 
antiguamente	 a n t i g u a m e n t e 
antiguo	 a n t i g u o 
antispam	 a n t i e s p a m 
antologia	a n t o l o x i a
antologia	 a n t o l o x i a 
antonio	 a n t o n i o 
anual	 a n u a l 
anuales	 a n u a l e s 
anuarios	 a n u a r i o s 
anunciar	 a n u n T i a r 
apache	 a p a C e 
aparato	 a p a r a t o 
aparece	 a p a r e T e 
aparecen	 a p a r e T e n 
apareceran	 a p a r e T e r a n 
aparecer	 a p a r e T e r 
aparecia	 a p a r e T i a 
aparecian	a p a r e T i a n
aparecian	 a p a r e T i a n 
aparecido	 a p a r e T i d o 
apareciendo	 a p a r e T i e n d o 
aparezca	 a p a r e T k a 
aparezcan	 a p a r e T k a n 
apartado	 a p a r t a d o 
aparte	 a p a r t e 
apasionantes	 a p a s i o n a n t e s 
apellido	 a p e y i d o 
apenas	 a p e n a s 
api	 a p i 
aplicable	 a p l i k a b l e 
aplicacion	 a p l i k a T i o n 
aplicaciones	 a p l i k a T i o n e s 
aplicadas	 a p l i k a d a s 
aplicado	 a p l i k a d o 
aplicamos	 a p l i k a m o s 
aplicando	 a p l i k a n d o 
aplicar	 a p l i k a r 
aplicativos	 a p l i k a t i b o s 
aporta	 a p o r t a 
aportabamos	 a p o r t a b a m o s 
aportacion	 a p o r t a T i o n 
aportaciones	 a p o r t a T i o n e s 
aportado	 a p o r t a d o 
aportados	 a p o r t a d o s 
aportan	 a p o r t a n 
aportando	 a p o r t a n d o 
aportar	 a p o r t a r 
aporte	 a p o r t e 
aporto	 a p o r t o 
apostado	 a p o s t a d o 
apostando	 a p o s t a n d o 
apostar	 a p o s t a r 
apoyada	 a p o y a d a 
apoyando	 a p o y a n d o 
apoyar	 a p o y a r 
apoyo	 a p o y o 
apoyos	 a p o y o s 
application	a p l i k e i C o n
apreciacion	 a p r e T i a T i o n 
aprecie	 a p r e T i e 
aprende	 a p r e n d e 
aprendemos	 a p r e n d e m o s 
aprender	 a p r e n d e r 
aprenderse	 a p r e n d e r s e 
aprendes	 a p r e n d e s 
aprendia	 a p r e n d i a 
aprendido	 a p r e n d i d o 
aprendiendo	 a p r e n d i e n d o 
aprendieron	 a p r e n d i e r o n 
aprendimos	 a p r e n d i m o s 
aprendizaje	 a p r e n d i T a x e 
aprendo	 a p r e n d o 
apropiadamente	 a p r o p i a d a m e n t e 
apropiadas	 a p r o p i a d a s 
apropiado	 a p r o p i a d o 
apropiar	 a p r o p i a r 
aprovechando	 a p r o b e C a n d o 
aprovechara	 a p r o b e C a r a 
aprovechar	 a p r o b e C a r 
aprovecharlo	 a p r o b e C a r l o 
aproximacion	 a p r o k s i m a T i o n 
aproximaciones	 a p r o k s i m a T i o n e s 
aproximadamente	 a p r o k s i m a d a m e n t e 
aproximado	 a p r o k s i m a d o 
aproximados	 a p r o k s i m a d o s 
aproximarlo	 a p r o k s i m a r l o 
apuesta	 a p u e s t a 
apuesto	 a p u e s t o 
apunta	 a p u n t a 
apuntar	 a p u n t a r 
apunte	 a p u n t e 
apunto	 a p u n t o 
aquel	 a k e l 
aquella	 a k e y a 
aquellas	 a k e y a s 
aquello	 a k e y o 
aquellos	 a k e y o s 
aqui	a k i
aqui	 a k i 
arafat	 a r a f a t 
arancha	 a r a n C a 
arbol	a r b o l
arbol	 a r b o l 
arboles	a r b o l e s
arboles	 a r b o l e s 
arbusto	 a r b u s t o 
archivo	 a r C i b o 
archivos	 a r C i b o s 
arco	 a r k o 
area	 a r e a 
areas	 a r e a s 
armario	 a r m a r i o 
armonica	 a r m o n i k a 
armonizar	 a r m o n i T a r 
arquitecto	 a r k i t e k t o 
arquitectura	 a r k i t e k t u r a 
arranca	 a R a n k a 
arrancar	 a R a n k a r 
arrastramos	 a R a s t r a m o s 
arrebatemos	 a R e b a t e m o s 
arreglado	 a R e g l a d o 
arreglamos	 a R e g l a m o s 
arriba	 a R i b a 
arriesgadas	 a R i e s g a d a s 
arriesgan	 a R i e s g a n 
ars	a e R e e T e
art	a r t
arte	 a r t e 
articulo	a r t i k u l o	
articulo	 a r t i k u l o 
articulos	 a r t i k u l o s 
artificial	 a r t i f i T i a l 
artistas	 a r t i s t a s 
artistico	 a r t i s t i k o 
as	 a s 
asegura	 a s e g u r a 
asegurada	 a s e g u r a d a 
aseguro	 a s e g u r o 
asentados	 a s e n t a d o s 
asesoraba	 a s e s o r a b a 
asesor	 a s e s o r 
asesores	 a s e s o r e s 
asia	 a s i a 
asi	a s i
asi	 a s i 
asiatica	 a s i a t i k a 
asiaticas	 a s i a t i k a s 
asiaticos	 a s i a t i k o s 
asignacion	 a s i g n a T i o n 
asirios	 a s i r i o s 
asistas	 a s i s t a s 
asistencia	 a s i s t e n T i a 
asistencia	a s i s t e n T i a
asistente	 a s i s t e n t e 
asistentes	 a s i s t e n t e s 
asistida	 a s i s t i d a 
asistir	 a s i s t i r 
asisto	 a s i s t o 
ask	 a s k 
asociaciones	 a s o T i a T i o n e s 
asociada	 a s o T i a d a 
asociadas	 a s o T i a d a s 
asociado	 a s o T i a d o 
asociar	 a s o T i a r 
aspecto	 a s p e k t o 
aspectos	 a s p e k t o s 
aspirar	 a s p i r a r 
asume	 a s u m e 
asumiendo	 a s u m i e n d o 
asumir	 a s u m i r 
asumo	 a s u m o 
asunto	 a s u n t o 
atencion	a t e n T i o n
atencion	 a t e n T i o n 
atendemos	 a t e n d e m o s 
atender	 a t e n d e r 
atendidas	 a t e n d i d a s 
atendido	 a t e n d i d o 
atendiendo	 a t e n d i e n d o 
atienden	 a t i e n d e n 
atipico	 a t i p i k o 
atipicos	 a t i p i k o s 
atom	a t o m
atos	 a t o s 
atractiva	 a t r a k t i b a 
atractivo	 a t r a k t i b o 
atraer	 a t r a e r 
atrapado	 a t r a p a d o 
atrasado	 a t r a s a d o 
atras	a t r a s
atras	 a t r a s 
atravesarlo	 a t r a b e s a r l o 
atraviesa	 a t r a b i e s a 
atrevemos	 a t r e b e m o s 
atrevia	 a t r e b i a 
atributo	 a t r i b u t o 
atributos	 a t r i b u t o s 
audiencia	 a u d i e n T i a 
audiencias	 a u d i e n T i a s 
audio	 a u d i o 
auge	 a u x e 
aulas	 a u l a s 
aumenta	 a u m e n t a 
aumentabamos	a u m e n t a b a m o s
aumentabamos	 a u m e n t a b a m o s 
aumentamos	 a u m e n t a m o s 
aumentar	 a u m e n t a r 
aun	 a u n 
aun	 a u n 
aunque	 a u n k e 
ausencia	 a u s e n T i a 
australia	 a u s t r a l i a 
australiano	 a u s t r a l i a n o 
austria	 a u s t r i a 
autentica	 a u t e n t i k a 
autentico	 a u t e n t i k o 
autoaprendizaje	 a u t o a p r e n d i T a x e 
auto	 a u t o 
autoemplearnos	 a u t o e m p l e a r n o s 
autoempleo	 a u t o e m p l e o 
autofinancia	 a u t o f i n a n T i a 
autofinanciamos	 a u t o f i n a n T i a m o s 
automatica	a u t o m a t i k a
automatica	 a u t o m a t i k a 
automaticamente	a u t o m a t i k a m e n t e
automaticamente	 a u t o m a t i k a m e n t e 
automaticas	 a u t o m a t i k a s 
automatico	a u t o m a t i k o
automatico	 a u t o m a t i k o 
automaticstrans	 a u t o m a t i k s t r a n s 
automatizase	 a u t o m a t i T a s e 
autonoma	 a u t o n o m a 
autonomas	 a u t o n o m a s 
autonomy	a u t o n o m i
autor	 a u t o r 
autores	 a u t o r e s 
autoria	 a u t o r i a 
auxilios	 a u k s i l i o s 
avanzada	 a b a n T a d a 
avanzadas	 a b a n T a d a s 
avanzado	 a b a n T a d o 
avanzados	 a b a n T a d o s 
avanzando	 a b a n T a n d o 
avanzar	 a b a n T a r 
ave	 a b e 
aventura	 a b e n t u r a 
average	 a b e r e C 
averiguar	 a b e r i g u a r 
axial	 a k s i a l 
axis	 a k s i s 
ay	 a i 
ayala	 a y a l a 
ayer	 a y e r 
ayuda	 a y u d a 
ayudado	 a y u d a d o 
ayudandose	 a y u d a n d o s e 
ayudar	 a y u d a r 
ayudaron	 a y u d a r o n 
ayudas	 a y u d a s 
ayuden	 a y u d e n 
ayudenme	 a y u d e n m e 
ayudo	 a y u d o 
ayudo	 a y u d o 
ayuntamiento	 a y u n t a m i e n t o 
ayuntamientos	 a y u n t a m i e n t o s 
azafran	 a T a f r a n 
azar	 a T a r 
azul	 a T u l 
backup	 b a k a p 
baeza	 b a e T a 
bag	b a x
bagging	b a g i n
bah	 b a 
baja	 b a x a 
bajada	 b a x a d a 
bajando	 b a x a n d o 
bajara	 b a x a r a 
bajar	 b a x a r 
bajas	 b a x a s 
bajo	 b a x o 
bajos	 b a x o s 
balanceada	 b a l a n T e a d a 
banco	 b a n k o 
barato	 b a r a t o 
barcelona	 b a r T e l o n a 
barco	 b a r k o 
barra	 b a R a 
barras	 b a R a s 
barrera	 b a R e r a 
barreras	 b a R e r a s 
basa	 b a s a 
basada	 b a s a d a 
basado	 b a s a d o 
basandonos	 b a s a n d o n o s 
basandose	b a s a n d o s e
basandose	 b a s a n d o s e 
basar	 b a s a r 
base	 b a s e 
based	b e i s d
baseline	b a T e l i n
bases	 b a s e s 
basica	 b a s i k a 
basical	b e i s i k a l
basicamente	b a s i k a m e n t e
basicamente	 b a s i k a m e n t e 
basicas	 b a s i k a s 
basico	 b a s i k o 
basicos	 b a s i k o s 
basketball	 b a s k e t b o l 
bastante	 b a s t a n t e 
bastantes	 b a s t a n t e s 
basura	 b a s u r a 
b	b e 
bbk	b e b e k a
beatles	 b i t e l s 
bebe	 b e b e 
be	b i
beca	 b e k a 
becas	 b e k a s 
bender	 b e n d e r 
beneficiar	 b e n e f i T i a r 
beneficiaria	 b e n e f i T i a r i a 
beneficiarse	 b e n e f i T i a r s e 
beneficio	 b e n e f i T i o 
beneficios	 b e n e f i T i o s 
beneficioso	 b e n e f i T i o s o 
berga	 b e r g a 
berkeley	 b e r k l e i 
berrilan	 b e R i l a n 
bestial	 b e s t i a l 
beyond	b i y o n d
bibliografia	 b i b l i o g r a f i a 
bibliografica	 b i b l i o g r a f i k a 
bibliometria	 b i b l i o m e t r i a 
bibliometricos	 b i b l i o m e t r i k o s 
biblioteca	 b i b l i o t e k a 
bibliotecario	 b i b l i o t e k a r i o 
bibliotecas	 b i b l i o t e k a s 
bic	 b i k 
bicicleta	 b i T i k l e t a 
bien	 b i e n 
bigramas	 b i g r a m a s 
bilingüe	 b i l i n g u e 
binariamente	 b i n a r i a m e n t e 
binario	 b i n a r i o 
bioamerica	 b i o a m e r i k a 
bio	 b i o 
biologia	 b i o l o x i a 
biologos	 b i o l o g o s 
biology	b a i o l o y i
biomedicina	 b i o m e d i T i n a 
biotecnologia	 b i o t e k n o l o x i a 
bitext	 b i t e k s 
blanco	 b l a n k o 
blog	 b l o g 
blogs	 b l o g s 
bloques	 b l o k e s 
boe	 b o e 
boecilla	 b o e T i y a 
bola	 b o l a 
bolonia	 b o l o n i a 
bolsa	 b o l s a 
bolsillo	 b o l s i y o 
bomba	 b o m b a 
bonita	 b o n i t a 
bonitas	 b o n i t a s 
bonito	 b o n i t o 
book	b u k
booleana	 b o o l e a n a 
booleanas	 b o o l e a n a s 
booleano	 b o o l e a n o 
boom	 b u m 
boris	 b o r i s 
borracha	 b o R a C a 
borrador	 b o R a d o r 
borramos	 b o R a m o s 
borrar	 b o R a r 
borroso	 b o R o s o 
bosque	 b o s k e 
bosquejo	 b o s k e x o 
botabamos	b o t a b a m o s
botabamos	 b o t a b a m o s 
botamos	 b o t a m o s 
botar	 b o t a r 
botin	 b o t i n 
botones	 b o t o n e s 
brazos	 b r a T o s 
brecha	 b r e C a 
brechas	 b r e C a s 
breve	 b r e b e 
brevedad	 b r e b e d a d 
brevemente	 b r e b e m e n t e 
breves	 b r e b e s 
broma	 b r o m a 
bronca	 b r o n k a 
brutos	 b r u t o s 
btob	b e t o b
buena	 b u e n a 
buenaga	 b u e n a g a 
buenas	 b u e n a s 
buen	 b u e n 
buenisima	 b u e n i s i m a 
bueno	 b u e n o 
buenos	 b u e n o s 
buf	 b u f 
building	b i l d i n g
built	b i l t
bullicion	 b u y i T i o n 
bulto	 b u l t o 
burbuja	 b u r b u x a 
bursatil	 b u r s a t i l 
buscaba	 b u s k a b a 
buscabamos	b u s k a b a m o s
buscabamos	 b u s k a b a m o s 
buscaban	 b u s k a b a n 
busca	 b u s k a 
buscada	 b u s k a d a 
buscadas	 b u s k a d a s 
buscador	 b u s k a d o r 
buscadores	 b u s k a d o r e s 
buscamos	 b u s k a m o s 
buscan	 b u s k a n 
buscando	 b u s k a n d o 
buscara	 b u s k a r a 
buscar	 b u s k a r 
buscare		b u s k a r e
buscare	 b u s k a r e 
buscaria	 b u s k a r i a 
buscarse	 b u s k a r s e 
buscarte	 b u s k a r t e 
buscas	 b u s k a s 
busco	 b u s k o 
busco	 b u s k o 
busque	 b u s k e 
busqueda	b u s k e d a
busqueda	 b u s k e d a 
busquedas	 b u s k e d a s 
busquen	 b u s k e n 
cabecera	 k a b e T e r a 
cabeceras	 k a b e T e r a s 
cabe	 k a b e 
cabeza	 k a b e T a 
cabo	 k a b o 
cabria	 k a b r i a 
cada	 k a d a 
cadena	 k a d e n a 
cadenas	 k a d e n a s 
cafe	k a f e
cafe	 k a f e 
caixa	 k a i s a 
caja	 k a x a 
cajita	 k a x i t a 
calculado	 k a l k u l a d o 
calcula	 k a l k u l a 
calculan	 k a l k u l a n 
calcular	 k a l k u l a r 
calculo	k a l k u l o
calculo	 k a l k u l o 
calculos	k a l k u l o s
calculos	 k a l k u l o s 
calibre	 k a l i b r e 
calidad	 k a l i d a d 
california	 k a l i f o r n i a 
callcenter	c o l c e n t e r
callcenters	c o l c e n t e r s
calle	 k a y e 
calles	 k a y e s 
camara	k a m a r a
camara	 k a m a r a 
camareros	 k a m a r e r o s 
cambiaba	 k a m b i a b a 
cambiado	 k a m b i a d o 
cambia	 k a m b i a 
cambiando	 k a m b i a n d o 
cambiar	 k a m b i a r 
cambio	 k a m b i o 
cambridge	 k e m b r i r e 
camino	 k a m i n o 
caminos	 k a m i n o s 
camiseta	 k a m i s e t a 
cam	 k a m 
campaña	 k a m p a N a 
campañas	 k a m p a N a s 
campo	 k a m p o 
campos	 k a m p o s 
campusred	 k a m p u s R e d 
canada	 k a n a d a 
canadienses	 k a n a d i e n s e s 
canales	 k a n a l e s 
canalizando	 k a n a l i T a n d o 
cancer	 k a n T e r 
canciller	 k a n T i y e r 
candidata	 k a n d i d a t a 
candidato	 k a n d i d a t o 
candidatos	 k a n d i d a t o s 
cangrejo	 k a n g r e x o 
cangrejos	 k a n g r e x o s 
cantidades	 k a n t i d a d e s 
cantidad	 k a n t i d a d 
caos	 k a o s 
caotica	 k a o t i k a 
capaces	 k a p a T e s 
capacidad	 k a p a T i d a d 
capa	 k a p a 
capaz	 k a p a T 
capita	 k a p i t a 
capita	 k a p i t a 
capitalizacion	 k a p i t a l i T a T i o n 
capital	 k a p i t a l 
captado	 k a p t a d o 
captar	 k a p t a r 
captura	 k a p t u r a 
capturan	 k a p t u r a n 
capturar	 k a p t u r a r 
caracteres	 k a r a k t e r e s 
caracteristica	k a r a k t e r i s t i k a
caracteristica	 k a r a k t e r i s t i k a 
caracteristicas	 k a r a k t e r i s t i k a s 
caracter	 k a r a k t e r 
cara	 k a r a 
caras	 k a r a s 
cardiacas	 k a r d i a k a s 
carencias	 k a r e n T i a s 
cargar	 k a r g a r 
cargas	 k a r g a s 
car	k a r
carlos	 k a r l o s 
carrera	 k a R e r a 
carreteras	 k a R e t e r a s 
carro	 k a R o 
carros	 k a R o s 
cartas	 k a r t a s 
cartel	 k a r t e l 
cartera	 k a r t e r a 
casa	 k a s a 
casar	 k a s a r 
casaron	 k a s a r o n 
casi	 k a s i 
caso	 k a s o 
casos	 k a s o s 
castellano	 k a s t e y a n o 
castellanos	 k a s t e y a n o s 
castellon	 k a s t e y o n 
casualidad	 k a s u a l i d a d 
casuistica	 k a s u i s t i k a 
catalana	 k a t a l a n a 
catalanas	 k a t a l a n a s 
catalanes	 k a t a l a n e s 
catalanismo	 k a t a l a n i s m o 
catalan	 k a t a l a n 
catalanohablantes	 k a t a l a n o a b l a n t e s 
catalogaciones	 k a t a l o g a T i o n e s 
catalogacion	 k a t a l o g a T i o n 
catalogada	 k a t a l o g a d a 
catalogadas	 k a t a l o g a d a s 
catalogado	 k a t a l o g a d o 
catalogadores	 k a t a l o g a d o r e s 
catalogador	 k a t a l o g a d o r 
catalogados	 k a t a l o g a d o s 
catalogan	 k a t a l o g a n 
catalogar	 k a t a l o g a r 
catalogarla	 k a t a l o g a r l a 
catalogo	 k a t a l o g o 
catalogos	 k a t a l o g o s 
cataluña	 k a t a l u N a 
catastrofico	 k a t a s t r o f i k o 
categoria	 k a t e g o r i a 
categorias	 k a t e g o r i a s 
categorizacion	 k a t e g o r i T a T i o n 
categoriza	 k a t e g o r i T a 
categorizar	 k a t e g o r i T a r 
categorizarla	 k a t e g o r i T a r l a 
catherine	c a T e r i n
cat	 k a t 
catorce	 k a t o r T e 
causa	 k a u s a 
cd	T e d e
c	 r e 
cebra	 T e b r a 
cedo	 T e d o 
celebramos	 T e l e b r a m o s 
celebra	 T e l e b r a 
celebro	 T e l e b r o 
celulares	 T e l u l a r e s 
centenas	 T e n t e n a s 
centradas	 T e n t r a d a s 
centrada	 T e n t r a d a 
centrado	 T e n t r a d o 
centralista	 T e n t r a l i s t a 
central	 T e n t r a l 
centramos	 T e n t r a m o s 
centrandose	 T e n t r a n d o s e 
centrando	 T e n t r a n d o 
centrarnos	 T e n t r a r n o s 
centrarse	 T e n t r a r s e 
centrar	 T e n t r a r 
centra	 T e n t r a 
centremos	 T e n t r e m o s 
centre	 T e n t r e 
centros	 T e n t r o s 
centro	 T e n t r o 
cercanas	 T e r k a n a s 
cercana	 T e r k a n a 
cercania	 T e r k a n i a 
cercanos	 T e r k a n o s 
cerca	 T e r k a 
cero	 T e r o 
cerrabamos	T e R a b a m o s
cerrabamos	 T e R a b a m o s 
cerrada	 T e R a d a 
cerrados	 T e R a d o s 
cerrado	 T e R a d o 
cerrar	 T e R a r 
certeza	 T e r t e T a 
cervantes	 T e r b a n t e s 
ce	 T e 
challenge	C a l e n y
charla	 C a r l a 
charlar	 C a r l a r 
charlas	 C a r l a s 
chato	 C a t o 
chats	 C a t s 
chavales	 C a b a l e s 
chico	 C i k o 
chile	 C i l e 
china	 C i n a 
chinito	 C i n i t o 
chino	 C i n o 
chiquitita	 C i k i t i t a 
chorrada	 C o R a d a 
chulas	 C u l a s 
chulo	 C u l o 
chusco	 C u s k o 
cia	 T i a 
cibermetria	 T i b e r m e t r i a 
ciberneticos	 T i b e r n e t i k o s 
ciclo	 T i k l o 
cielo	 T i e l o 
ciencias	 T i e n T i a s 
ciencia	 T i e n T i a 
cien	 T i e n 
cientifica	T i e n t i f i k a
cientifica	 T i e n t i f i k a 
cientificos	 T i e n t i f i k o s 
cientifico	 T i e n t i f i k o 
cientos	 T i e n t o s 
ciento	 T i e n t o 
ciertamente	 T i e r t a m e n t e 
ciertas	 T i e r t a s 
cierta	 T i e r t a 
ciertos	 T i e r t o s 
cierto	 T i e r t o 
cifras	 T i f r a s 
cifra	 T i f r a 
cinco	 T i n k o 
cincuenta	 T i n k u e n t a 
cindoc	 T i n d o k 
circulacion	 T i r k u l a T i o n 
circundan	 T i r k u n d a n 
circunde	 T i r k u n d e 
citaros	 T i t a r o s 
citar	 T i t a r 
citas	 T i t a s 
citation	s a i t e i C o n
cita	 T i t a 
ciudadanos	 T i u d a d a n o s 
ciudadano	 T i u d a d a n o 
ciudad	 T i u d a d 
clara	 k l a r a 
claramente	 k l a r a m e n t e 
claras	 k l a r a s 
clarisimamente	 k l a r i s i m a m e n t e 
claro	 k l a r o 
claros	 k l a r o s 
clase	 k l a s e 
clases	 k l a s e s 
clasica	k l a s i k a
clasica	 k l a s i k a 
clasico	k l a s i k o
clasico	 k l a s i k o 
clasificaciones	 k l a s i f i k a T i o n e s 
clasificacion	k l a s i f i k a T i o n
clasificacion	 k l a s i f i k a T i o n 
clasificadas	 k l a s i f i k a d a s 
clasificadores	 k l a s i f i k a d o r e s 
clasificadores	k l a s i f i k a d o r e s
clasificador	 k l a s i f i k a d o r 
clasificador	k l a s i f i k a d o r
clasificados	 k l a s i f i k a d o s 
clasifica	 k l a s i f i k a 
clasificamos	 k l a s i f i k a m o s 
clasifican	 k l a s i f i k a n 
clasificar	 k l a s i f i k a r 
clasificarlas	 k l a s i f i k a r l a s 
classic	k l a s i k
classifier	k l a s i f a i e r
clavada	 k l a b a d a 
clave	 k l a b e 
claves	 k l a b e s 
clavo	 k l a b o 
clef	 k l e f 
clicando	 k l i k a n d o 
clickando	k l i k a n d o
cliente	 k l i e n t e 
clientela	 k l i e n t e l a 
clientes	 k l i e n t e s 
clima	 k l i m a 
clinica	 k l i n i k a 
clinicas	 k l i n i k a s 
clinicos	 k l i n i k o s 
clustering	 k l a s t e r i n 
cnn	T e e n e e n e
cobertura	 k o b e r t u r a 
cobran	 k o b r a n 
cobrar	 k o b r a r 
cobrarla	 k o b r a r l a 
cobrarlo	 k o b r a r l o 
cobras	 k o b r a s 
coca cola	 k o k a k o l a 
cocacola	k o k a k o l a
coca	 k o k a 
coche	 k o C e 
coches	 k o C e s 
cocina	 k o T i n a 
codigo	 k o d i g o 
codigos	 k o d i g o s 
coge	 k o x e 
cogemos	 k o x e m o s 
cogera	 k o x e r a 
cogeran	 k o x e r a n 
coger	 k o x e r 
cogerla	 k o x e r l a 
cogerlo	 k o x e r l o 
coges	 k o x e s 
cogian	 k o x i a n 
cogido	 k o x i d o 
cogiendo	 k o x i e n d o 
cognitivo	 k o g n i t i b o 
cogolla	 k o g o y a 
coherente	 k o e r e n t e 
cohn	 k o n 
coincide	 k o i n T i d e 
coincidencia	 k o i n T i d e n T i a 
coja	 k o x a 
colaboracion	 k o l a b o r a T i o n 
colabora	 k o l a b o r a 
colaboran	 k o l a b o r a n 
colaborar	 k o l a b o r a r 
colaboren	 k o l a b o r e n 
cola	 k o l a 
colchon	 k o l C o n 
colecciones	 k o l e k T i o n e s 
coleccion	 k o l e k T i o n 
colegas	 k o l e g a s 
colegio	 k o l e x i o 
colgado	 k o l g a d o 
colgamos	 k o l g a m o s 
colocando	 k o l o k a n d o 
colocan	 k o l o k a n 
colocar	 k o l o k a r 
colocarlo	 k o l o k a r l o 
colombia	 k o l o m b i a 
colon	 k o l o n 
coloquial	 k o l o k i a l 
colores	 k o l o r e s 
colores	k o l o r e s
colorines	 k o l o r i n e s 
color	 k o l o r 
columna	 k o l u m n a 
coma	 k o m a 
comando	 k o m a n d o 
comandos	 k o m a n d o s 
combatir	 k o m b a t i r 
combinaba	 k o m b i n a b a 
combinaciones	 k o m b i n a T i o n e s 
combinacion	 k o m b i n a T i o n 
combinado	 k o m b i n a d o 
combinando	 k o m b i n a n d o 
combinandolo	 k o m b i n a n d o l o 
combinandolos	 k o m b i n a n d o l o s 
combinan	 k o m b i n a n 
combinar	 k o m b i n a r 
comentaba	 k o m e n t a b a 
comentabamos	 k o m e n t a b a m o s 
comentado	 k o m e n t a d o 
comenta	 k o m e n t a 
comentamos	 k o m e n t a m o s 
comentando	 k o m e n t a n d o 
comentarais	 k o m e n t a r a i s 
comentare	 k o m e n t a r e 
comentario	 k o m e n t a r i o 
comentarios	 k o m e n t a r i o s 
comentar	 k o m e n t a r 
comento	 k o m e n t o 
comento	 k o m e n t o 
comenzare	 k o m e n T a r e 
comenzar	 k o m e n T a r 
comenzo	 k o m e n T o 
comerciales	 k o m e r T i a l e s 
comerciales	k o m e r T i a l e s
comercializacion	 k o m e r T i a l i T a T i o n 
comercial	 k o m e r T i a l 
comercio	 k o m e r T i o 
comer	 k o m e r 
cometido	 k o m e t i d o 
comicas	 k o m i k a s 
comiendome	 k o m i e n d o m e 
comienzo	 k o m i e n T o 
comillas	 k o m i y a s 
comision	 k o m i s i o n 
comites	 k o m i t e s 
com	 k o m 
com	k o m
comodo	 k o m o d o 
como	 k o m o 
como	 k o m o 
compañero	 k o m p a N e r o 
compañeros	 k o m p a N e r o s 
compañia	 k o m p a N i a 
compañias	k o m p a N i a
compañias	 k o m p a N i a s 
comparables	 k o m p a r a b l e s 
comparaciones	 k o m p a r a T i o n e s 
comparacion	k o m p a r a T i o n
comparacion	 k o m p a r a T i o n 
comparado	 k o m p a r a d o 
comparais	k o m p a r a i s
comparais	 k o m p a r a i s 
compara	 k o m p a r a 
comparamos	 k o m p a r a m o s 
comparando	 k o m p a r a n d o 
comparandolo	 k o m p a r a n d o l o 
comparan	 k o m p a r a n 
comparar	 k o m p a r a r 
compararla	 k o m p a r a r l a 
comparativa	 k o m p a r a t i b a 
comparativas	 k o m p a r a t i b a s 
comparativo	 k o m p a r a t i b o 
comparen	 k o m p a r e n 
compartir	 k o m p a r t i r 
compartis	 k o m p a r t i s 
competencia	 k o m p e t e n T i a 
competiciones	 k o m p e t i T i o n e s 
competicion	k o m p e t i T i o n
competicion	 k o m p e t i T i o n 
competidores	 k o m p e t i d o r e s 
competir	 k o m p e t i r 
competitiva	 k o m p e t i t i b a 
competitivo	 k o m p e t i t i b o 
compite	 k o m p i t e 
compitiendo	 k o m p i t i e n d o 
complecion	 k o m p l e T i o n 
compleja	 k o m p l e x a 
complejo	 k o m p l e x o 
complejos	 k o m p l e x o s 
complementan	 k o m p l e m e n t a n 
complementaria	 k o m p l e m e n t a r i a 
complementario	 k o m p l e m e n t a r i o 
complementar	 k o m p l e m e n t a r 
complementarlos	 k o m p l e m e n t a r l o s 
complementos	 k o m p l e m e n t o s 
completa	 k o m p l e t a 
completamente	 k o m p l e t a m e n t e 
completan	 k o m p l e t a n 
completar	 k o m p l e t a r 
completarla	 k o m p l e t a r l a 
completaron	 k o m p l e t a r o n 
completas	 k o m p l e t a s 
completo	 k o m p l e t o 
complicada	 k o m p l i k a d a 
complicado	 k o m p l i k a d o 
complicado	k o m p l i k a d o
complica	 k o m p l i k a 
complicar	 k o m p l i k a r 
complutense	 k o m p l u t e n s e 
compone	 k o m p o n e 
componente	 k o m p o n e n t e 
componentes	 k o m p o n e n t e s 
comporta	 k o m p o r t a 
comportamiento	 k o m p o r t a m i e n t o 
comportan	 k o m p o r t a n 
compraba	 k o m p r a b a 
comprados	 k o m p r a d o s 
compra	 k o m p r a 
comprame	 k o m p r a m e 
comprando	 k o m p r a n d o 
compran	 k o m p r a n 
comprar	 k o m p r a r 
compraron	 k o m p r a r o n 
compras	 k o m p r a s 
comprendan	 k o m p r e n d a n 
comprender	 k o m p r e n d e r 
compren	 k o m p r e n 
comprension	 k o m p r e n s i o n 
comprimiendose	k o m p r i m i e n d o s e
comprimiendose	 k o m p r i m i e n d o s e 
comprobado	 k o m p r o b a d o 
comprobamos	 k o m p r o b a m o s 
comprobar	 k o m p r o b a r 
compro	 k o m p r o 
comprometen	 k o m p r o m e t e n 
comprometer	 k o m p r o m e t e r 
compromiso	 k o m p r o m i s o 
computacio	 k o m p u t a T i o 
computacional	 k o m p u t a T i o n a l 
computadora	 k o m p u t a d o r a 
computadoras	 k o m p u t a d o r a s 
comunicaciones	 k o m u n i k a T i o n e s 
comunicacion	 k o m u n i k a T i o n 
comunicando	 k o m u n i k a n d o 
comunicar	 k o m u n i k a r 
comunicarse	 k o m u n i k a r s e 
comunidades	 k o m u n i d a d e s 
comunidad	 k o m u n i d a d 
comun	 k o m u n 
concedan	 k o n T e d a n 
concentrar	 k o n T e n t r a r 
concentrarse	 k o n T e n t r a r s e 
concepto	 k o n T e p t o 
conceptos	 k o n T e p t o s 
conciencia	 k o n T i e n T i a 
concienciarnos	 k o n T i e n T i a r n o s 
conciso	 k o n T i s o 
concluir	 k o n k l u i r 
conclusiones	 k o n k l u s i o n e s 
conclusion	k o n k l u s i o n
conclusion	 k o n k l u s i o n 
concreta	 k o n k r e t a 
concretas	 k o n k r e t a s 
concreto	 k o n k r e t o 
concretos	 k o n k r e t o s 
concurrencia	 k o n k u R e n T i a 
concurrir	 k o n k u R i r 
concursan	 k o n k u r s a n 
concursar	 k o n k u r s a r 
concurso	 k o n k u r s o 
concursos	 k o n k u r s o s 
condicionamiento	 k o n d i T i o n a m i e n t o 
condiciones	 k o n d i T i o n e s 
conduce	 k o n d u T e 
conectada	 k o n e k t a d a 
conectarla	 k o n e k t a r l a 
conectarse	 k o n e k t a r s e 
conectores	 k o n e k t o r e s 
conejos	 k o n e x o s 
conexion	 k o n e k s i o n 
conferencias	 k o n f e r e n T i a s 
confiado	 k o n f i a d o 
confianza	 k o n f i a n z a 
confias	 k o n f i a s 
confidenciales	 k o n f i d e n T i a l e s 
configuracion	 k o n f i g u r a T i o n 
configurar	 k o n f i g u r a r 
confirmamos	 k o n f i r m a m o s 
confusa	 k o n f u s a 
congreso	 k o n g r e s o 
congresos	 k o n g r e s o s 
conjunto	 k o n x u n t o 
con	 k o n 
con	k o n
conoceis	 k o n o T e i s 
conoce	 k o n o T e 
conocemos	 k o n o T e m o s 
conocen	 k o n o T e n 
conoceran	 k o n o T e r a n 
conocereis	 k o n o T e r e i s 
conocer	 k o n o T e r 
conocerse	 k o n o T e r s e 
conocia	 k o n o T i a 
conociamos	 k o n o T i a m o s 
conocida	 k o n o T i d a 
conocido	 k o n o T i d o 
conocidos	 k o n o T i d o s 
conocimiento	 k o n o T i m i e n t o 
conocimientos	 k o n o T i m i e n t o s 
conozcais	 k o n o T k a i s 
conozco	 k o n o T k o 
conquistar	 k o n k i s t a r 
conscientes	 k o n s T i e n t e s 
consecuencia	 k o n s e k u e n T i a 
consecutivos	 k o n s e k u t i b o s 
conseguia	 k o n s e g i a 
conseguido	 k o n s e g i d o 
consegui	 k o n s e g i 
conseguimos	 k o n s e g i m o s 
conseguir	 k o n s e g i r 
conseguirlo	 k o n s e g i r l o 
conseguis	 k o n s e g i s 
consejeria	 k o n s e x e r i a 
consejo	 k o n s e x o 
conservar	 k o n s e r b a r 
consideraba	 k o n s i d e r a b a 
considerable	 k o n s i d e r a b l e 
considera	 k o n s i d e r a 
consideramos	 k o n s i d e r a m o s 
considerando	 k o n s i d e r a n d o 
consideran	 k o n s i d e r a n 
considerar	 k o n s i d e r a r 
consigan	 k o n s i g a n 
consigo	 k o n s i g o 
consigue	 k o n s i g e 
consiguen	 k o n s i g e n 
consigues	 k o n s i g e s 
consiste	 k o n s i s t e 
consistente	 k o n s i s t e n t e 
consolidados	 k o n s o l i d a d o s 
consolidando	 k o n s o l i d a n d o 
consolidarse	 k o n s o l i d a r s e 
consorcio	 k o n s o r T i o 
consorcios	 k o n s o r T i o s 
consta	 k o n s t a 
constante	 k o n s t a n t e 
constituido	 k o n s t i t u i d o 
constituimos	 k o n s t i t u i m o s 
constituye	 k o n s t i t u y e 
constituyendo	 k o n s t i t u y e n d o 
construccion	 k o n s t r u k T i o n 
construimos	 k o n s t r u i m o s 
construir	 k o n s t r u i r 
construyen	 k o n s t r u y e n 
construyo	 k o n s t r u y o 
consulta	 k o n s u l t a 
consultar	 k o n s u l t a r 
consultas	 k o n s u l t a s 
consultoras	 k o n s u l t o r a s 
consultores	 k o n s u l t o r e s 
consultoria	 k o n s u l t o r i a 
consultor	 k o n s u l t o r 
consumida	 k o n s u m i d a 
consumo	 k o n s u m o 
contaba	 k o n t a b a 
contabilidad	 k o n t a b i l i d a d 
contacto	 k o n t a k t o 
contactos	 k o n t a k t o s 
contado	 k o n t a d o 
contaminado	 k o n t a m i n a d o 
contamos	 k o n t a m o s 
contara	 k o n t a r a 
contar	 k o n t a r 
contaros	 k o n t a r o s 
contempla	 k o n t e m p l a 
contemplamos	 k o n t e m p l a m o s 
contemplan	 k o n t e m p l a n 
contemplarse	 k o n t e m p l a r s e 
contengan	 k o n t e n g a n 
contenido	 k o n t e n i d o 
contenidos	 k o n t e n i d o s 
contento	 k o n t e n t o 
contestaban	 k o n t e s t a b a n 
contesta	 k o n t e s t a 
contestando	 k o n t e s t a n d o 
contestan	 k o n t e s t a n 
contestara	 k o n t e s t a r a 
contestar	 k o n t e s t a r 
conteste	 k o n t e s t e 
contexto	 k o n t e k s t o 
contextos	 k o n t e k s t o s 
contextuales	 k o n t e k s t u a l e s 
contextual	 k o n t e k s t u a l 
contiene	 k o n t i e n e 
contienen	 k o n t i e n e n 
continentes	 k o n t i n e n t e s 
contingencia	 k o n t i n x e n T i a 
continuacion	 k o n t i n u a T i o n 
continua	 k o n t i n u a 
continuamente	 k o n t i n u a m e n t e 
continuar	 k o n t i n u a r 
continuidad	 k o n t i n u i d a d 
conto	k o n t o
conto	 k o n t o 
contradiccion	 k o n t r a d i k T i o n 
contradictorio	 k o n t r a d i k t o r i o 
contra	 k o n t r a 
contrapartida	 k o n t r a p a r t i d a 
contrapuestos	 k o n t r a p u e s t o s 
contrario	 k o n t r a r i o 
contraste	 k o n t r a s t e 
contrataciones	 k o n t r a t a T i o n e s 
contratacion	 k o n t r a t a T i o n 
contratar	 k o n t r a t a r 
contrato	 k o n t r a t o 
contratos	 k o n t r a t o s 
contreras	 k o n t r e r a s 
contribuciones	 k o n t r i b u T i o n e s 
contribucion	 k o n t r i b u T i o n 
contribuia	 k o n t r i b u i a 
controlada	 k o n t r o l a d a 
controladas	 k o n t r o l a d a s 
controlado	 k o n t r o l a d o 
controlar	 k o n t r o l a r 
control	 k o n t r o l 
convencido	 k o m b e n T i d o 
convencidos	 k o m b e n T i d o s 
convenci	k o m b e n T i
convenci	 k o m b e n T i 
convencional	 k o m b e n T i o n a l 
convendria	 k o m b e n d r i a 
convenzan	 k o m b e n T a n 
conversion	 k o m b e r s i o n 
convertian	 k o m b e r t i a n 
convertido	 k o m b e r t i d o 
convertir	 k o m b e r t i r 
convertirlo	 k o m b e r t i r l o 
convertirlos	 k o m b e r t i r l o s 
convierte	 k o m b i e r t e 
convirtiendo	 k o m b i r t i e n d o 
convirtio	 k o m b i r t i o 
convocatoria	 k o m b o k a t o r i a 
convocatorias	 k o m b o k a t o r i a s 
cooperacion	 k o o p e r a T i o n 
cooperan	 k o o p e r a n 
coordinacion	 k o o r d i n a T i o n 
coordinador	 k o o r d i n a d o r 
coordinados	 k o o r d i n a d o s 
copa	 k o p a 
copia	 k o p i a 
copias	 k o p i a s 
copie	 k o p i e 
copien	 k o p i e n 
corazon	 k o r a T o n 
corea	 k o r e a 
cores	 k o r e s 
corparables	 k o r p a r a b l e s 
corporate	 k o r p o r a t e 
corporativa	 k o r p o r a t i b a 
corporativas	 k o r p o r a t i b a s 
corporativos	 k o r p o r a t i b o s 
corpus	 k o r p u s 
correccion	 k o R e k T i o n 
correcta	 k o R e k t a 
correctas	 k o R e k t a s 
correcto	 k o R e k t o 
correctores	 k o R e k t o r e s 
corrector	 k o R e k t o r 
correctos	 k o R e k t o s 
correggio	 k o R e g i o 
corregirme	 k o R e x i r m e 
correlacion	 k o R e l a T i o n 
correo	 k o R e o 
corresponda	 k o R e s p o n d a 
corresponde	 k o R e s p o n d e 
corresponden	 k o R e s p o n d e n 
correspondera	 k o R e s p o n d e r a 
correspondian	k o R e s p o n d i a n
correspondian	 k o R e s p o n d i a n 
correspondiente	 k o R e s p o n d i e n t e 
corroborar	 k o R o b o r a r 
cortada	 k o r t a d a 
corta	 k o r t a 
cortar	 k o r t a r 
corte	 k o r t e 
corto	 k o r t o 
corujo	 k o r u x o 
cosa	 k o s a 
cosas	 k o s a s 
cosita	 k o s i t a 
costado	 k o s t a d o 
costa	 k o s t a 
coste	 k o s t e 
costo	 k o s t o 
costosisima	 k o s t o s i s i m a 
costoso	 k o s t o s o 
crawler	k r o l e r
crawlers	k r o l e r s
crawl	k r o l
creacion	 k r e a T i o n 
creada	 k r e a d a 
creadas	 k r e a d a s 
creado	 k r e a d o 
creados	 k r e a d o s 
creais	 k r e a i s 
crea	 k r e a 
creamos	 k r e a m o s 
creando	 k r e a n d o 
crean	 k r e a n 
crear	 k r e a r 
crearse	 k r e a r s e 
creas	 k r e a s 
creativa	 k r e a t i b a 
crece	 k r e T e 
crecen	 k r e T e n 
crecer	 k r e T e r 
creciendo	 k r e T i e n d o 
crecimiento	 k r e T i m i e n t o 
credibilidad	 k r e d i b i l i d a d 
credito	 k r e d i t o 
creeis	 k r e e i s 
cree	 k r e e 
creemos	 k r e e m o s 
creen	 k r e e n 
creer	 k r e e r 
crees	 k r e e s 
creo	 k r e o 
creo	 k r e o 
crezca	 k r e T k a 
cria	 k r i a 
criatura	 k r i a t u r a 
crisis	 k r i s i s 
cristian	 k r i s t i a n 
cristobal	 k r i s t o b a l 
criterio	 k r i t e r i o 
criterios	 k r i t e r i o s 
criticas	 k r i t i k a s 
critico	 k r i t i k o 
croacia	 k r o a T i a 
cross	k r o s
cruzada	 k r u T a d a 
cruzar	 k r u T a r 
csic	T e s i k
ct	T e t e
cuadernillo	 k u a d e r n i y o 
cuadradito	 k u a d r a d i t o 
cuadraditos	 k u a d r a d i t o s 
cuadrado	 k u a d r a d o 
cuadrados	 k u a d r a d o s 
cuadrantes	 k u a d r a n t e s 
cuadro	 k u a d r o 
cuadros	 k u a d r o s 
cua	k u a
cuales	 k u a l e s 
cuales	k u a l e s
cuales	 k u a l e s 
cualidades	 k u a l i d a d e s 
cualitativamente	 k u a l i t a t i b a m e n t e 
cualitativo	 k u a l i t a t i b o 
cual	 k u a l 
cual	 k u a l 
cualquiera	 k u a l k i e r a 
cualquier	 k u a l k i e r 
cuando	 k u a n d o 
cuando	 k u a n d o 
cuantas	 k u a n t a s 
cuantas	 k u a n t a s 
cuantifica	 k u a n t i f i k a 
cuantitativas	 k u a n t i t a t i b a s 
cuantitativo	 k u a n t i t a t i b o 
cuantitativos	 k u a n t i t a t i b o s 
cuanto	 k u a n t o 
cuanto	 k u a n t o 
cuantos	 k u a n t o s 
cuantos	 k u a n t o s 
cuarenta	 k u a r e n t a 
cuarta	 k u a r t a 
cuarto	 k u a r t o 
cuatrocientos	 k u a t r o T i e n t o s 
cuatrocientos	k u a t r o T i e n t o s
cuatro	 k u a t r o 
cuberto	 k u b e r t o 
cubierto	 k u b i e r t o 
cubre	 k u b r e 
cubrir	 k u b r i r 
cuelga	 k u e l g a 
cuelgan	 k u e l g a n 
cuenta	 k u e n t a 
cuentame	 k u e n t a m e 
cuentan	 k u e n t a n 
cuentas	 k u e n t a s 
cuente	 k u e n t e 
cuento	 k u e n t o 
cuero	 k u e r o 
cuerpo	 k u e r p o 
cuesta	 k u e s t a 
cuestan	 k u e s t a n 
cuestionan	 k u e s t i o n a n 
cuestionario	 k u e s t i o n a r i o 
cuestionarios	 k u e s t i o n a r i o s 
cuestiones	 k u e s t i o n e s 
cuestion	 k u e s t i o n 
cuidado	 k u i d a d o 
cuidamos	 k u i d a m o s 
cuidar	 k u i d a r 
culpa	 k u l p a 
cultivo	 k u l t i b o 
cultura	 k u l t u r a 
culturales	 k u l t u r a l e s 
cultural	 k u l t u r a l 
cumple	 k u m p l e 
cumplen	 k u m p l e n 
cumples	 k u m p l e s 
cumplimentar	 k u m p l i m e n t a r 
cumplir	 k u m p l i r 
curiosa	 k u r i o s a 
curiosamente	 k u r i o s a m e n t e 
curiosidades	 k u r i o s i d a d e s 
curiosidad	 k u r i o s i d a d 
curioso	 k u r i o s o 
curriculum	 k u R i k u l u m 
curso	 k u r s o 
cursos	 k u r s o s 
custodiar	 k u s t o d i a r 
cuya	 k u y a 
cuyo	 k u y o 
cybermetria	 T i b e r m e t r i a 
cybermetrico	 T i b e r m e t r i k o 
cybermetrics	T a i b e r m e t r i k s
cytit	T a i t i t
daba	 d a b a 
dabais	 d a b a i s 
dabamos	 d a b a m o s 
da	 d a 
dada	 d a d a 
dadas	 d a d a s 
dado	 d a d o 
daedalus	d a e d a l u s
daedalus	 d e d a l u s 
dais	 d a i s 
damos	 d a m o s 
dan	 d a n 
dando	 d a n d o 
dandole	 d a n d o l e 
dandoles	 d a n d o l e s 
danone	 d a n o n e 
dara	 d a r a 
dar	 d a r 
daria	 d a r i a 
dariamos	 d a r i a m o s 
darle	 d a r l e 
darles	 d a r l e s 
daros	 d a r o s 
darse	 d a r s e 
das	 d a s 
data	d e i t a
dataset	d a t a s e t
dato	 d a t o 
datos	 d a t o s 
day	d e i
d	 d e
dea	 d e a 
debajo	 d e b a x o 
debate	 d e b a t e 
debatirlo	 d e b a t i r l o 
debe	 d e b e 
debemos	 d e b e m o s 
deben	 d e b e n 
debera	 d e b e r a 
deberes	 d e b e r e s 
deberia	d e b e r i a
deberia	 d e b e r i a 
deberiamos	d e b e r i a m o s
deberiamos	 d e b e r i a m o s 
deberian	d e b e r i a n
deberian	 d e b e r i a n 
debido	 d e b i d o 
decada	 d e k a d a 
decentemente	 d e T e n t e m e n t e 
decentes	 d e T e n t e s 
decia	d e T i a
decia	 d e T i a 
deciamos	d e T i a m o s
deciamos	 d e T i a m o s 
decian	 d e T i a n 
decias	 d e T i a s 
decidamos	 d e T i d a m o s 
decidan	 d e T i d a n 
decide	 d e T i d e 
deciden	 d e T i d e n 
decides	 d e T i d e s 
decidido	 d e T i d i d o 
decidiera	 d e T i d i e r a 
decidimos	 d e T i d i m o s 
decidir	 d e T i d i r 
decimal	 d e T i m a l 
decimos	 d e T i m o s 
decir	 d e T i r 
decirle	 d e T i r l e 
decirles	 d e T i r l e s 
decirlo	 d e T i r l o 
decirme	 d e T i r m e 
deciros	 d e T i r o s 
decirte	 d e T i r t e 
decis	 d e T i s 
decision	 d e T i s i o n 
decision	 d e T i s i o n 
decisiones	 d e T i s i o n e s 
declara	 d e k l a r a 
de	 d e 
de	d e
de	 d e 
dedicaarsela	d e d i c a r s e l a	
dedicaban	 d e d i k a b a n 
dedicada	 d e d i k a d a 
dedicadas	 d e d i k a d a s 
dedica	 d e d i k a 
dedicado	 d e d i k a d o 
dedicados	 d e d i k a d o s 
dedicais	 d e d i k a i s 
dedicamos	 d e d i k a m o s 
dedican	 d e d i k a n 
dedicar	 d e d i k a r 
dedicarsela	 d e d i k a r s e l a 
dedique	 d e d i k e 
dedo	 d e d o 
deductivo	 d e d u k t i b o 
defecto	 d e f e k t o 
defectuosos	 d e f e k t u o s o s 
defender	 d e f e n d e r 
defensa	 d e f e n s a 
defensor	 d e f e n s o r 
defiendan	 d e f i e n d a n 
define	 d e f i n e 
definen	 d e f i n e n 
definia	 d e f i n i a 
definian	 d e f i n i a n 
definicion	 d e f i n i T i o n 
definiciones	 d e f i n i T i o n e s 
definida	 d e f i n i d a 
definido	 d e f i n i d o 
definidos	 d e f i n i d o s 
definiendo	 d e f i n i e n d o 
definieron	 d e f i n i e r o n 
definimos	 d e f i n i m o s 
definir	 d e f i n i r 
definire	 d e f i n i r e 
definirlo	 d e f i n i r l o 
definiros	 d e f i n i r o s 
deformacion	d e f o r m a T i o n
deformacion	 d e f o r m a T i o n 
deforma	 d e f o r m a 
deformar	 d e f o r m a r 
deis	 d e i s 
dejaba	 d e x a b a 
deja	 d e x a 
dejado	 d e x a d o 
dejame	d e x a m e
dejame	 d e x a m e 
dejan	 d e x a n 
dejando	 d e x a n d o 
dejar	 d e x a r 
dejaron	 d e x a r o n 
deje	d e x e
deje	 d e x e 
dejo	 d e x o 
delante	 d e l a n t e 
delante	d e l a n t e
del	 d e l 
deletree	 d e l e t r e e 
deletreeme	 d e l e t r e e m e 
delimitador	 d e l i m i t a d o r 
delimitadores	 d e l i m i t a d o r e s 
delimitar	 d e l i m i t a r 
demanda	 d e m a n d a 
demandado	 d e m a n d a d o 
demas	d e m a s
demas	 d e m a s 
demasiadas	 d e m a s i a d a s 
demasiado	 d e m a s i a d o 
demo	 d e m o 
demografia	 d e m o g r a f i a 
demografica	 d e m o g r a f i k a 
demonios	 d e m o n i o s 
demostracion	d e m o s t r a T i o n
demostracion	 d e m o s t r a T i o n 
demostrado	 d e m o s t r a d o 
demostrandose	 d e m o s t r a n d o s e 
demostrar	 d e m o s t r a r 
demuestra	 d e m u e s t r a 
demuestran	 d e m u e s t r a n 
demuestren	 d e m u e s t r e n 
den	 d e n 
denego	 d e n e g o 
denomina	 d e n o m i n a 
denominado	 d e n o m i n a d o 
denominados	 d e n o m i n a d o s 
denominamos	 d e n o m i n a m o s 
denostada	 d e n o s t a d a 
denso	 d e n s o 
dentro	 d e n t r o 
departamento	 d e p a r t a m e n t o 
departamentos	 d e p a r t a m e n t o s 
depende	 d e p e n d e 
depender	 d e p e n d e r 
dependiendo	 d e p e n d i e n d o 
dependiente	 d e p e n d i e n t e 
deportes	 d e p o r t e s 
deportistas	 d e p o r t i s t a s 
deprimente	 d e p r i m e n t e 
derecha	 d e r e C a 
derechas	 d e r e C a s 
derecho	 d e r e C o 
derechos	 d e r e C o s 
derivados	 d e r i b a d o s 
derroteros	 d e R o t e r o s 
desafio	d e s a f i o
desafio	 d e s a f i o 
desafortunadamente	 d e s a f o r t u n a d a m e n t e 
desagregar	 d e s a g r e g a r 
desambigua	 d e s a m b i g u a 
desaparecian	 d e s a p a r e T i a n 
desarrollada	 d e s a R o y a d a 
desarrolla	 d e s a R o y a 
desarrollado	 d e s a R o y a d o 
desarrolladora	 d e s a R o y a d o r a 
desarrolladores	 d e s a R o y a d o r e s 
desarrollados	 d e s a R o y a d o s 
desarrollamos	 d e s a R o y a m o s 
desarrollando	 d e s a R o y a n d o 
desarrollara	 d e s a R o y a r a 
desarrollar	 d e s a R o y a r 
desarrollarla	 d e s a R o y a r l a 
desarrollarlo	 d e s a R o y a r l o 
desarrollarlos	 d e s a R o y a r l o s 
desarrollarse	 d e s a R o y a r s e 
desarrollasemos	 d e s a R o y a s e m o s 
desarrollo	 d e s a R o y o 
desarrollo	 d e s a R o y o 
desarrollos	 d e s a R o y o s 
desastre	 d e s a s t r e 
desastrosa	 d e s a s t r o s a 
descargarme	 d e s k a r g a r m e 
descartamos	 d e s k a r t a m o s 
descartan	 d e s k a r t a n 
descartar	 d e s k a r t a r 
descendemos	 d e s T e n d e m o s 
descender	 d e s T e n d e r 
descomponer	 d e s k o m p o n e r 
descomponerlo	 d e s k o m p o n e r l o 
desconcertados	 d e s k o n T e r t a d o s 
desconocida	 d e s k o n o T i d a 
desconocido	 d e s k o n o T i d o 
desconocidos	 d e s k o n o T i d o s 
desconocimiento	 d e s k o n o T i m i e n t o 
describe	 d e s k r i b e 
describen	 d e s k r i b e n 
describir	 d e s k r i b i r 
describiros	 d e s k r i b i r o s 
descripcion	d e s c r i p T i o n
descripcion	 d e s k r i p T i o n 
descripciones	 d e s k r i p T i o n e s 
descriptivos	 d e s k r i p t i b o s 
descripto	d e s c r i p t o
descripto	 d e s k r i p t o 
descriptor	 d e s k r i p t o r 
descrito	 d e s k r i t o 
descubierto	 d e s k u b i e r t o 
descubiertos	 d e s k u b i e r t o s 
descubra	 d e s k u b r a 
descubran	 d e s k u b r a n 
descubrimos	 d e s k u b r i m o s 
descubrio	 d e s k u b r i o 
descubrir	 d e s k u b r i r 
desde	 d e s d e 
des	 d e s 
deseable	 d e s e a b l e 
deseandolo	 d e s e a n d o l o 
deseleccionar	 d e s e l e k T i o n a r 
desesperadamente	 d e s e s p e r a d a m e n t e 
desesperados	 d e s e s p e r a d o s 
desesperaran	 d e s e s p e r a r a n 
desfavorecidos	 d e s f a b o r e T i d o s 
desglose	 d e s g l o s e 
desgraciadamente	 d e s g r a T i a d a m e n t e 
desgracia	 d e s g r a T i a 
desgracias	 d e s g r a T i a s 
designar	 d e s i g n a r 
deslocalizando	 d e s l o k a l i T a n d o 
desmayamos	 d e s m a y a m o s 
desorden	 d e s o r d e n 
despacho	 d e s p a C o 
despachos	 d e s p a C o s 
despegando	 d e s p e g a n d o 
despiertan	 d e s p i e r t a n 
despistarte	 d e s p i s t a r t e 
despliegue	 d e s p l i e g e 
desprecia	 d e s p r e T i a 
despreciar	 d e s p r e T i a r 
desprender	 d e s p r e n d e r 
despues	d e s p u e s
despues	 d e s p u e s 
destacar	 d e s t a k a r 
destiempo	 d e s t i e m p o 
destinada	 d e s t i n a d a 
destino	 d e s t i n o 
destructurar	 d e s t r u k t u r a r 
detallado	 d e t a y a d o 
detallados	 d e t a y a d o s 
detallar	 d e t a y a r 
detalle	 d e t a y e 
detalles	 d e t a y e s 
deteccion	d e t e k T i o n
deteccion	 d e t e k T i o n 
detectada	 d e t e k t a d a 
detecta	 d e t e k t a 
detectado	 d e t e k t a d o 
detectamos	 d e t e k t a m o s 
detectando	 d e t e k t a n d o 
detectar	 d e t e k t a r 
detecte	 d e t e k t e 
detecto	 d e t e k t o 
detecto	d t e k t o
detector	 d e t e k t o r 
detectores	 d e t e k t o r e s 
determinada	 d e t e r m i n a d a 
determinadas	 d e t e r m i n a d a s 
determina	 d e t e r m i n a 
determinado	 d e t e r m i n a d o 
determinados	 d e t e r m i n a d o s 
determinante	 d e t e r m i n a n t e 
determinar	 d e t e r m i n a r 
detras	 d e t r a s 
deutsche	 d o i C e 
devolviera	 d e b o l b i e r a 
devuelto	 d e b u e l t o 
devuelva	 d e b u e l b a 
devuelve	 d e b u e l b e 
devuelven	 d e b u e l b e n 
dia	d i a
dia	 d i a 
diagnostico	 d i a g n o s t i k o 
diagnosticos	 d i a g n o s t i k o s 
diagonal	 d i a g o n a l 
diagrama	 d i a g r a m a 
diagramas	 d i a g r a m a s 
dialnet	 d i a l n e t 
dialogar	 d i a l o g a r 
dialogo	 d i a l o g o 
diapositiva	 d i a p o s i t i b a 
diapositivas	 d i a p o s i t i b a s 
diaria	 d i a r i a 
diariamente	 d i a r i a m e n t e 
diario	 a d i a r i o 
dias	d i a s
dias	 d i a s 
diaz	 d i a T 
dibujada	 d i b u x a d a 
dibujito	 d i b u x i t o 
dibujitos	 d i b u x i t o s 
dibujo	 d i b u x o 
dibujos	 d i b u x o s 
diccionario	 d i k T i o n a r i o 
diccionario	d k T i o n a r i o	
diccionarios	 d i k T i o n a r i o s 
dice	 d i T e 
dicen	 d i T e n 
dices	 d i T e s 
dicha	 d i C a 
dichas	 d i C a s 
dicho	 d i C o 
dichos	 d i C o s 
diciendo	 d i T i e n d o 
di	 d i 
dieciocho	 d i e T i o C o 
dieciseis	d i e T i s e i s
dieciseis	 d i e T i s e i s 
diecisiete	 d i e T i s i e t e 
diera	 d i e r a 
dieron	 d i e r o n 
dietterich	d i e t e r i C
diez	 d i e T 
diferenciacion	 d i f e r e n T i a T i o n 
diferencia	 d i f e r e n T i a 
diferenciamos	 d i f e r e n T i a m o s 
diferenciarnos	 d i f e r e n T i a r n o s 
diferenciarse	 d i f e r e n T i a r s e 
diferencias	 d i f e r e n T i a s 
diferente	 d i f e r e n t e 
diferentes	 d i f e r e n t e s 
dificil	d i f i T i l
dificil	 d i f i T i l 
dificiles	d i f i T i l e s
dificiles	 d i f i T i l e s 
dificualtad	 d i f i k u a l t a d 
dificultad	 d i f i k u l t a d 
dificultades	 d i f i k u l t a d e s 
dificulta	 d i f i k u l t a 
difundais	 d i f u n d a i s 
difundir	 d i f u n d i r 
difusion	 d i f u s i o n 
diga	 d i g a 
digais	 d i g a i s 
digamos	 d i g a m o s 
digan	 d i g a n 
diganme	d i g a n m e
diganme	 d i g a n m e 
digas	 d i g a s 
digital	 d i x i t a l 
digitales	 d i x i t a l e s 
digitalizacion	 d i x i t a l i T a T i o n 
digo	 d i g o 
dije	 d i x e 
dijeramos	 d i x e r a m o s 
dijeron	 d i x e r o n 
dijimos	 d i x i m o s 
dijo	 d i x o 
dilatarlo	 d i l a t a r l o 
dilbert	 d i l b e r t 
dile	 d i l e 
dimensionados	 d i m e n s i o n a d o s 
dimensionalidad	 d i m e n s i o n a l i d a d 
dimensionar	 d i m e n s i o n a r 
dimension	d i m e n s i o n
dimension	 d i m e n s i o n 
dimensiones	 d i m e n s i o n e s 
dimos	 d i m o s 
dinamica	 d i n a m i k a 
dinamico	 d i n a m i k o 
dinero	 d i n e r o 
dineros	 d i n e r o s 
dio	 d i o 
dios	 d i o s 
diputacion	 d i p u t a T i o n 
direccion	 d i r e k T i o n 
direcciones	 d i r e k T i o n e s 
directa	 d i r e k t a 
directamente	 d i r e k t a m e n t e 
directas	 d i r e k t a s 
directo	 d i r e k t o 
director	 d i r e k t o r 
director	d i r e k t o r
directores	 d i r e k t o r e s 
directorio	 d i r e k t o r i o 
directorios	 d i r e k t o r i o s 
directory	d i r e k t o r i
directos	 d i r e k t o s 
dire	 d i r e 
diria	 d i r i a 
dirias	 d i r i a s 
dirigida	 d i r i x i d a 
dirigimos	 d i r i x i m o s 
dirigir	 d i r i x i r 
dirigirnos	 d i r i x i r n o s 
disciplina	 d i s T i p l i n a 
disciplinar	 d i s T i p l i n a r 
disciplinas	 d i s T i p l i n a s 
disco	 d i s k o 
discografica	 d i s k o g r a f i k a 
discograficas	 d i s k o g r a f i k a s 
discordancia	 d i s k o r d a n T i a 
discos	 d i s k o s 
discriminantes	 d i s k r i m i n a n t e s 
disculpadme	 d i s k u l p a d m e 
disculpas	 d i s k u l p a s 
discusion	d i s k u s i o n
discusion	 d i s k u s i o n 
discusiones	 d i s k u s i o n e s 
discute	 d i s k u t e 
discuten	 d i s k u t e n 
discutido	 d i s k u t i d o 
discutiendo	 d i s k u t i e n d o 
discutir	 d i s k u t i r 
discutirlo	 d i s k u t i r l o 
diseñada	 d i s e N a d a 
diseña	 d i s e N a 
diseñador	 d i s e N a d o r 
diseñados	 d i s e N a d o s 
diseñamos	 d i s e N a m o s 
diseñar	 d i s e N a r 
diseño	 d i s e N o 
diseños	 d i s e N o s 
disgustaria	 d i s g u s t a r i a 
disminuya	 d i s m i n u y a 
disminuye	 d i s m i n u y e 
dispar	 d i s p a r 
disparidad	 d i s p a r i d a d 
dispersa	 d i s p e r s a 
disponemos	 d i s p o n e m o s 
disponen	 d i s p o n e n 
disponer	 d i s p o n e r 
disponibilidad	 d i s p o n i b i l i d a d 
disponible	 d i s p o n i b l e 
disponibles	 d i s p o n i b l e s 
disposicion	 d i s p o s i T i o n 
dispuesta	 d i s p u e s t a 
dispuesto	 d i s p u e s t o 
disquete	 d i s k e t e 
distancia	 d i s t a n T i a 
distinguir	 d i s t i n g i r 
distinta	 d i s t i n t a 
distintas	 d i s t i n t a s 
distinto	 d i s t i n t o 
distintos	 d i s t i n t o s 
distribucion	 d i s t r i b u T i o n 
distribuido	 d i s t r i b u i d o 
distribuir	 d i s t r i b u i r 
distribuya	 d i s t r i b u y a 
distribuyen	 d i s t r i b u y e n 
diversa	 d i b e r s a 
diversas	 d i b e r s a s 
dividido	 d i b i d i d o 
dividir	 d i b i d i r 
divisiones	 d i b i s i o n e s 
divorcio	 d i b o r T i o 
dni	d e e n e i
doble	 d o b l e 
doc	 d o k 
doce	 d o T e 
docena	 d o T e n a 
docencia	 d o T e n T i a 
doctorado	 d o k t o r a d o 
doctoral	 d o k t o r a l 
doctorales	 d o k t o r a l e s 
doctor	 d o k t o r 
doctores	 d o k t o r e s 
documentacion	d o k u m e n t a T i o n
documentacion	 d o k u m e n t a T i o n 
documentados	 d o k u m e n t a d o s 
documental	 d o k u m e n t a l 
documentalistas	 d o k u m e n t a l i s t a s 
documentar	 d o k u m e n t a r 
documento	 d o k u m e n t o 
documentos	 d o k u m e n t o s 
domingo	 d o m i n g o 
dominio	 d o m i n i o 
dominios	 d o m i n i o s 
donde	 d o n d e 
donde	 d o n d e 
don	 d o n 
dont	d o n t
dormido	 d o r m i d o 
doscientas	 d o s T i e n t a s 
doscientos	 d o s T i e n t o s 
dos	 d o s 
dos	d o s
dotan	 d o t a n 
doy	 d o i 
dramatica	 d r a m a t i k a 
duda	 d u d a 
dudas	 d u d a s 
dudemos	 d u d e m o s 
dudo	 d u d o 
dulce	 d u l T e 
dura	 d u r a 
durante	 d u r a n t e 
durar	 d u r a r 
duras	 d u r a s 
duro	 d u r o 
duros	 d u r o s 
ebay	 i b e i 
echado	 e C a d o 
echamos	 e C a m o s 
echaron	 e C a r o n 
echen	 e C e n 
ecologica	 e k o l o x i k a 
economica	 e k o n o m i k a 
economicamente	 e k o n o m i k a m e n t e 
economicas	 e k o n o m i k a s 
economico	 e k o n o m i k o 
economicos	 e k o n o m i k o s 
economistas	 e k o n o m i s t a s 
ecuacion	 e k u a T i o n 
edicion	 e d i T i o n 
edificio	 e d i f i T i o 
edificios	 e d i f i T i o s 
editar	 e d i t a r 
educacion	 e d u k a T i o n 
educared	 e d u k a R e d 
educarle	 e d u k a r l e 
educativo	 e d u k a t i b o 
edu	 e d u 
e	 e 
efectivamente	 e f e k t i b a m e n t e 
efectivo	 e f e k t i b o 
efecto	 e f e k t o 
efectos	 e f e k t o s 
efectua	 e f e k t u a 
efe	 e f e 
eficaces	 e f i k a T e s 
eficacia	 e f i k a T i a 
eficaz	 e f i k a T 
eficiencia	 e f i T i e n T i a 
eficiente	 e f i T i e n t e 
eh	 e 
eicstes	 e i k s t e s 
ejecuciones	 e x e k u T i o n e s 
ejecuta	 e x e k u t a 
ejemplares	 e x e m p l a r e s 
ejemplar	 e x e m p l a r 
ejemplo	 e x e m p l o 
ejemplos	 e x e m p l o s 
ejercito	e x e r T i t o
ejercito	 e x e r T i t o 
ejes	 e x e s 
ejmeplo	e x e m p l o
elaborada	 e l a b o r a d a 
elaborado	 e l a b o r a d o 
elcano	 e l k a n o 
electronica	 e l e k t r o n i k a 
electronicas	 e l e k t r o n i k a s 
electronico	 e l e k t r o n i k o 
electronicos	 e l e k t r o n i k o s 
elegante	 e l e g a n t e 
elegantes	 e l e g a n t e s 
elegido	 e l e x i d o 
elegimos	 e l e x i m o s 
elegir	 e l e x i r 
eleka	 e l e k a 
el	 e l 
el	e l
el	 e l 
elemento	 e l e m e n t o 
elementos	 e l e m e n t o s 
elevada	 e l e b a d a 
elevados	 e l e b a d o s 
elhuyar	 e l u y a r 
elige	 e l i x e 
eligiendo	 e l i x i e n d o 
eligieron	 e l i x i e r o n 
elijamos	 e l i x a m o s 
eliminar	 e l i m i n a r 
eliminarlas	 e l i m i n a r l a s 
eliseo	 e l i s e o 
elite	 e l i t e 
ella	 e y a 
ellas	 e y a s 
ello	 e y o 
ellos	 e y o s 
embargo	 e m b a r g o 
embargos	 e m b a r g o s 
embrion	 e m b r i o n 
embutido	 e m b u t i d o 
eme	 e m e 
emergiendo	 e m e r x i e n d o 
emilio	 e m i l i o 
emita	 e m i t a 
emocionaba	 e m o T i o n a b a 
empacho	 e m p a C o 
empalma	 e m p a l m a 
empece	 e m p e T e 
empecemos	 e m p e T e m o s 
empeñamos	 e m p e N a m o s 
empeñan	 e m p e N a n 
empezaba	 e m p e T a b a 
empezaban	 e m p e T a b a n 
empezado	 e m p e T a d o 
empezamos	 e m p e T a m o s 
empezando	 e m p e T a n d o 
empezare	 e m p e T a r e 
empezar	 e m p e T a r 
empezaron	 e m p e T a r o n 
empezo	 e m p e T o 
empiece	 e m p i e T e 
empieza	 e m p i e T a 
empiezan	 e m p i e T a n 
empiezas	 e m p i e T a s 
empiezo	 e m p i e T o 
empleados	 e m p l e a d o s 
empleamos	 e m p l e a m o s 
emplear	 e m p l e a r 
empleo	 e m p l e o 
empotrado	 e m p o t r a d o 
emprendedor	 e m p r e n d e d o r 
emprendedores	 e m p r e n d e d o r e s 
empresa	 e m p r e s a 
empresarial	 e m p r e s a r i a l 
empresariales	 e m p r e s a r i a l e s 
empresas	 e m p r e s a s 
empujamos	 e m p u x a m o s 
empujar	 e m p u x a r 
enamorado	 e n a m o r a d o 
encabezada	 e n k a b e T a d a 
encabezado	 e n k a b e T a d o 
encabezados	 e n k a b e T a d o s 
encabezamientos	 e n k a b e T a m i e n t o s 
encantada	 e n k a n t a d a 
encantado	 e n k a n t a d o 
encanta	 e n k a n t a 
encareceria	 e n k a r e T e r i a 
encargadas	 e n k a r g a d a s 
encargado	 e n k a r g a d o 
encarga	 e n k a r g a 
encargarse	 e n k a r g a r s e 
encargo	 e n k a r g o 
encarguen	 e n k a r g e n 
encender	 e n T e n d e r 
enchufa	 e n C u f a 
encima	 e n T i m a 
encomendado	 e n k o m e n d a d o 
encontraba	 e n k o n t r a b a 
encontrabais	 e n k o n t r a b a i s 
encontrabamos	 e n k o n t r a b a m o s 
encontraban	 e n k o n t r a b a n 
encontrabas	 e n k o n t r a b a s 
encontrado	 e n k o n t r a d o 
encontramos	 e n k o n t r a m o s 
encontrando	 e n k o n t r a n d o 
encontrandose	 e n k o n t r a n d o s e 
encontrara	 e n k o n t r a r a 
encontrar	 e n k o n t r a r 
encontraria	 e n k o n t r a r i a 
encontrarla	 e n k o n t r a r l a 
encontrarse	 e n k o n t r a r s e 
encontro	 e n k o n t r o 
encuentra	 e n k u e n t r a 
encuentrala	 e n k u e n t r a l a 
encuentrame	 e n k u e n t r a m e 
encuentran	 e n k u e n t r a n 
encuentras	 e n k u e n t r a s 
encuentre	 e n k u e n t r e 
encuentren	 e n k u e n t r e n 
encuentro	 e n k u e n t r o 
encuesta	 e n k u e s t a 
encuestas	 e n k u e s t a s 
endesa	 e n d e s a 
endtime	e n d t a i m
ene	 e n e 
enemigo	 e n e m i g o 
en	 e n 
en	e n
energia	 e n e r x i a 
enero	 e n e r o 
enfasis	 e n f a s i s 
enfermedades	 e n f e r m e d a d e s 
enfermeria	 e n f e r m e r i a 
enfocado	 e n f o k a d o 
enfocarnos	 e n f o k a r n o s 
enfoques	 e n f o k e s 
enfrenta	 e n f r e n t a 
enfrentamos	 e n f r e n t a m o s 
enfrentan	 e n f r e n t a n 
enfrentar	 e n f r e n t a r 
enfrentarnos	 e n f r e n t a r n o s 
engañar	 e n g a N a r 
engañarme	 e n g a N a r m e 
engancha	 e n g a n C a 
enganchar	 e n g a n C a r 
enganche	 e n g a n C e 
engañoso	 e n g a N o s o 
engrescante	 e n g r e s k a n t e 
enlace	 e n l a T e 
enlaces	 e n l a T e s 
enlazados	 e n l a T a d o s 
enlaza	 e n l a T a 
enlazamos	 e n l a T a m o s 
enlazando	 e n l a T a n d o 
enlazan	 e n l a T a n 
enmarcados	 e n m a r k a d o s 
enmarcar	 e n m a r k a r 
enorme	 e n o r m e 
enric	 e n R i k 
enriquecida	 e n R i k e T i d a 
enriquecimiento	 e n R i k e T i m i e n t o 
enrique	 e n R i k e 
enseguida	 e n s e g i d a 
enseñado	 e n s e N a d o 
enseña	 e n s e N a 
enseñan	 e n s e N a n 
enseñanza	 e n s e N a n T a 
enseñaran	 e n s e N a r a n 
enseñare	 e n s e N a r e 
enseñar	 e n s e N a r 
enseñaros	 e n s e N a r o s 
enseño	 e n s e N o 
ensucia	 e n s u T i a 
ente	 e n t e 
entendemos	 e n t e n d e m o s 
entenderan	 e n t e n d e r a n 
entender	 e n t e n d e r 
entenderlo	 e n t e n d e r l o 
entendian	 e n t e n d i a n 
entendido	 e n t e n d i d o 
entendiendo	 e n t e n d i e n d o 
entendiera	 e n t e n d i e r a 
entendio	 e n t e n d i o 
entero	 e n t e r o 
entidad	 e n t i d a d 
entidades	 e n t i d a d e s 
entiende	 e n t i e n d e 
entienden	 e n t i e n d e n 
entiendo	 e n t i e n d o 
entonces	 e n t o n T e s 
entontrar	 e n t o n t r a r 
entorno	 e n t o r n o 
entornos	 e n t o r n o s 
entrabais	 e n t r a b a i s 
entrada	 e n t r a d a 
entra	 e n t r a 
entrambasaguas	 e n t r a m b a s a g u a s 
entrando	 e n t r a n d o 
entran	 e n t r a n 
entrantes	 e n t r a n t e s 
entrare	 e n t r a r e 
entrar	 e n t r a r 
entrariamos	 e n t r a r i a m o s 
entrasen	 e n t r a s e n 
entre	 e n t r e 
entregan	 e n t r e g a n 
entregar	 e n t r e g a r 
entremos	 e n t r e m o s 
entrenado	 e n t r e n a d o 
entrenamiento	 e n t r e n a m i e n t o 
entrenamientos	 e n t r e n a m i e n t o s 
entrenando	 e n t r e n a n d o 
entrenar	 e n t r e n a r 
entren	 e n t r e n 
entretenido	 e n t r e t e n i d o 
entretenimiento	 e n t r e t e n i m i e n t o 
entrevista	 e n t r e b i s t a 
entrevistaron	 e n t r e b i s t a r o n 
entro	 e n t r o 
entusiastas	 e n t u s i a s t a s 
envergadura	 e m b e r g a d u r a 
envia	 e m b i a 
enviamos	 e n b i a m o s 
envuelto	 e m b u e l t o 
eon	 e o n 
epfl	e p e e f e e l e
epidemiologicos	 e p i d e m i o l o x i k o s 
epoca	 e p o k a 
epocas	 e p o k a s 
equilibrados	 e k i l i b r a d o s 
equilibran	 e k i l i b r a n 
equipo	 e k i p o 
equipos	 e k i p o s 
equis	 e k i s 
equivalente	 e k i b a l e n t e 
equivoca	 e k i b o k a 
equivocamos	 e k i b o k a m o s 
equivocar	 e k i b o k a r 
equivocarme	 e k i b o k a r m e 
equivocarse	 e k i b o k a r s e 
equivoco	 e k i b o k o 
era	 e r a 
eramos	e r a m o s
eramos	 e r a m o s 
eran	 e r a n 
erasmus	 e r a s m u s 
eres	 e r e s 
ericsson	 e r i k s s o n 
erradicar	 e R a d i k a r 
erratico	 e R a t i k o 
erre	 e R e 
error	 e R o r 
errores	 e R o r e s 
esa	 e s a 
esa	 e s a 
esas	 e s a s 
escalable	 e s k a l a b l e 
escala	 e s k a l a 
escalas	 e s k a l a s 
escandinavos	 e s k a n d i n a b o s 
escaneres	 e s k a n e r e s 
escaso	 e s k a s o 
escenario	 e s T e n a r i o 
escenarios	 e s T e n a r i o s 
escocia	 e s k o T i a 
escoge	 e s k o x e 
escolarizacion	 e s k o l a r i T a T i o n 
escorial	 e s k o r i a l 
escriba	 e s k r i b a 
escriban	 e s k r i b a n 
escribe	 e s k r i b e 
escribes	 e s k r i b e s 
escribiendo	 e s k r i b i e n d o 
escribir	 e s k r i b i r 
escrita	 e s k r i t a 
escritas	 e s k r i t a s 
escrito	 e s k r i t o 
escritores	 e s k r i t o r e s 
escritor	 e s k r i t o r 
escritos	 e s k r i t o s 
escuchaba	 e s k u C a b a 
escuchado	 e s k u C a d o 
escuchais	 e s k u C a i s 
escuchamos	 e s k u C a m o s 
escuchando	 e s k u C a n d o 
escuchar	 e s k u C a r 
escuchas	 e s k u C a s 
escuche	 e s k u C e 
escucheis	 e s k u C e i s 
escuderias	 e s k u d e r i a s 
escuela	 e s k u e l a 
ese	 e s e 
ese	 e s e 
esencial	 e s e n T i a l 
esenciales	 e s e n T i a l e s 
es	 e s 
es	e s
esforcemos	 e s f o r T e m o s 
esfuerzo	 e s f u e r T o 
eso	 e s o 
esos	 e s o s 
espacio	 e s p a T i o 
espacios	 e s p a T i o s 
espacios	e s p a T i o s
espacios	e s p a T i o s
espacio-temporales	 e s p a T i o t e m p o r a l e s 
espaciotemporales	e s p a T i o t e m p o r a l e s
españa	 e s p a N a 
española	 e s p a N o l a 
españolas	 e s p a N o l a s 
españoles	 e s p a N o l e s 
español	 e s p a N o l 
especiales	 e s p e T i a l e s 
especial	 e s p e T i a l 
especialidades	 e s p e T i a l i d a d e s 
especializada	 e s p e T i a l i T a d a 
especializadas	 e s p e T i a l i T a d a s 
especializado	 e s p e T i a l i T a d o 
especializados	 e s p e T i a l i T a d o s 
especializar	 e s p e T i a l i T a r 
especialmente	 e s p e T i a l m e n t e 
especie	 e s p e T i e 
especifica	e s p e T i f i k a
especifica	 e s p e T i f i k a 
especificamente	 e s p e T i f i k a m e n t e 
especificas	 e s p e T i f i k a s 
especifico	 e s p e T i f i k o 
especificos	 e s p e T i f i k o s 
espectacular	 e s p e k t a k u l a r 
especulacion	 e s p e k u l a T i o n 
esperaba	 e s p e r a b a 
esperabamos	 e s p e r a b a m o s 
esperaban	 e s p e r a b a n 
espera	 e s p e r a 
esperamos	 e s p e r a m o s 
esperar	 e s p e r a r 
esperaria	 e s p e r a r i a 
esperas	 e s p e r a s 
esperemos	 e s p e r e m o s 
espero	 e s p e r o 
espiral	 e s p i r a l 
esquema	 e s k e m a 
esquemas	 e s k e m a s 
esquina	 e s k i n a 
estaba	 e s t a b a 
estabamos	 e s t a b a m o s 
estaban	 e s t a b a n 
establecer	 e s t a b l e T e r 
establecida	 e s t a b l e T i d a 
establecido	 e s t a b l e T i d o 
estableciendo	 e s t a b l e T i e n d o 
establezca	 e s t a b l e T k a 
estacionalidad	 e s t a T i o n a l i d a d 
estadistica	 e s t a d i s t i k a 
estadisticamente	 e s t a d i s t i k a m e n t e 
estadisticas	 e s t a d i s t i k a s 
estadistico	 e s t a d i s t i k o 
estadisticos	 e s t a d i s t i k o s 
estado	 e s t a d o 
estados	 e s t a d o s 
estadounidenses	 e s t a d o u n i d e n s e s 
esta	 e s t a 
esta	e s t a
esta	 e s t a 
esta	 e s t a 
estais	 e s t a i s 
estallido	 e s t a y i d o 
estamos	 e s t a m o s 
estancia	 e s t a n T i a 
estancias	 e s t a n T i a s 
estanco	 e s t a n k o 
estandares	 e s t a n d a r e s 
estandar	 e s t a n d a r 
estandarizacion	 e s t a n d a r i T a T i o n 
estando	 e s t a n d o 
estan	e s t a n
estan	 e s t a n 
estara	 e s t a r a 
estaran	 e s t a r a n 
estare	 e s t a r e 
estar	 e s t a r 
estaria	 e s t a r i a 
estariais	 e s t a r i a i s 
estariamos	 e s t a r i a m o s 
estarian	 e s t a r i a n 
estas	 e s t a s 
estas	 e s t a s 
estas	 e s t a s 
estatales	 e s t a t a l e s 
estatal	 e s t a t a l 
estaticas	 e s t a t i k a s 
estatico	 e s t a t i k o 
estaticos	 e s t a t i k o s 
estatua	 e s t a t u a 
estatua	e s t a t u a
estatus	 e s t a t u s 
este	 e s t e 
este	 e s t e 
este	 e s t e 
estemos	 e s t e m o s 
esten	 e s t e n 
estes	 e s t e s 
estilo	 e s t i l o 
estimacion	 e s t i m a T i o n 
estimado	 e s t i m a d o 
estimular	 e s t i m u l a r 
esto	 e s t o 
estos	 e s t o s 
estos	 e s t o s 
estoy	 e s t o i 
estrategia	 e s t r a t e x i a 
estrategias	 e s t r a t e x i a s 
estrategica	 e s t r a t e x i k a 
estrella	 e s t r e y a 
estrictamente	 e s t r i k t a m e n t e 
estructuracion	 e s t r u k t u r a T i o n 
estructurada	 e s t r u k t u r a d a 
estructurado	 e s t r u k t u r a d o 
estructurados	 e s t r u k t u r a d o s 
estructura	 e s t r u k t u r a 
estructuramos	 e s t r u k t u r a m o s 
estructurar	 e s t r u k t u r a r 
estructuras	 e s t r u k t u r a s 
estudiadas	 e s t u d i a d a s 
estudia	 e s t u d i a 
estudiamos	 e s t u d i a m o s 
estudiando	 e s t u d i a n d o 
estudiante	 e s t u d i a n t e 
estudiantes	 e s t u d i a n t e s 
estudiar	 e s t u d i a r 
estudiarlos	 e s t u d i a r l o s 
estudie	 e s t u d i e 
estudio	 e s t u d i o 
estudios	 e s t u d i o s 
estupenda	 e s t u p e n d a 
estupendo	 e s t u p e n d o 
estupida	 e s t u p i d a 
estuviera	 e s t u b i e r a 
estuvieran	 e s t u b i e r a n 
estuvieron	 e s t u b i e r o n 
estuviese	 e s t u b i e s e 
estuvimos	 e s t u b i m o s 
estuvo	 e s t u b o 
etapa	 e t a p a 
etapas	 e t a p a s 
etcetera	e t T e t e r a
etcetera	 e t T e t e r a 
etiquetado	 e t i k e t a d o 
etiquetas	 e t i k e t a s 
euro	 e u r o 
europa	 e u r o p a 
europea	 e u r o p e a 
europeas	 e u r o p e a s 
europeo	 e u r o p e o 
europeos	 e u r o p e o s 
euros	 e u r o s 
euskaltel	 e u s k a l t e l 
euskera	 e u s k e r a 
evaluaba	 e b a l u a b a 
evaluacion	 e b a l u a T i o n 
evaluaciones	 e b a l u a T i o n e s 
evaluadas	 e b a l u a d a s 
evaluadores	 e b a l u a d o r e s 
evaluar	 e b a l u a r 
evaluation	 e b a l u e i s i o n 
eventualmente	 e b e n t u a l m e n t e 
everybody	e b r i b o d i
evidencia	 e b i d e n T i a 
evidente	 e b i d e n t e 
evidentemente	 e b i d e n t e m e n t e 
evidentes	 e b i d e n t e s 
evil	i b i l
evitar	 e b i t a r 
evolucionando	 e b o l u T i o n a n d o 
evolucionan	 e b o l u T i o n a n 
evolucion	 e b o l u T i o n 
exacta	 e k s a k t a 
exactamente	 e k s a k t a m e n t e 
exactas	 e k s a k t a s 
exactitud	 e k s a k t i t u d 
exacto	 e k s a k t o 
exactos	 e k s a k t o s 
exageramos	 e k s a x e r a m o s 
exalead	 e k s a l e a d 
excelente	 e k s T e l e n t e 
excelentes	 e k s T e l e n t e s 
excepcion	 e k s T e p T i o n 
excepciones	 e k s T e p T i o n e s 
excepto	 e k s T e p t o 
excesiva	 e k s T e s i b a 
excesivamente	 e k s T e s i b a m e n t e 
excluidos	 e k s k l u i d o s 
exclusiva	 e k s k l u s i b a 
exclusivamente	 e k s k l u s i b a m e n t e 
exercise	e k s e r s a i s
exige	 e k s i x e 
exigia	 e k s i x i a 
exista	 e k s i s t a 
existe	 e k s i s t e 
existen	 e k s i s t e n 
existentes	 e k s i s t e n t e s 
existiria	 e k s i s t i r i a 
exito	 e k s i t o 
exitos	 e k s i t o s 
expandir	 e k s p a n d i r 
expansion	 e k s p a n s i o n 
expedientes	 e k s p e d i e n t e s 
experiencia	 e k s p e r i e n T i a 
experiencias	 e k s p e r i e n T i a s 
experimentacion	 e k s p e r i m e n t a T i o n 
experimentados	 e k s p e r i m e n t a d o s 
experimentales	 e k s p e r i m e n t a l e s 
experimentar	 e k s p e r i m e n t a r 
experimento	 e k s p e r i m e n t o 
experimentos	 e k s p e r i m e n t o s 
experto	 e k s p e r t o 
expertos	 e k s p e r t o s 
explicado	 e k s p l i k a d o 
explicale	 e k s p l i k a l e 
explicando	 e k s p l i k a n d o 
explicare	 e k s p l i k a r e 
explicar	 e k s p l i k a r 
explicarles	 e k s p l i k a r l e s 
explicaroslo	 e k s p l i k a r o s l o 
explicarte	 e k s p l i k a r t e 
explicativo	 e k s p l i k a t i b o 
explico	 e k s p l i k o 
explique	e k s p l i k e
explique	 e k s p l i k e 
explora	 e k s p l o r a 
exploramos	 e k s p l o r a m o s 
explorar	 e k s p l o r a r 
exploratorio	 e k s p l o r a t o r i o 
explotacion	 e k s p l o t a T i o n 
explotar	 e k s p l o t a r 
exponencial	 e k s p o n e n T i a l 
exponencialmente	 e k s p o n e n T i a l m e n t e 
exponer	 e k s p o n e r 
exposicion	 e k s p o s i T i o n 
exposiciones	 e k s p o s i T i o n e s 
expresa	 e k s p r e s a 
expresamente	 e k s p r e s a m e n t e 
expresion	 e k s p r e s i o n 
expresiones	 e k s p r e s i o n e s 
exprimiendo	 e k s p r i m i e n d o 
exprimir	 e k s p r i m i r 
extender	 e k s t e n d e r 
extenderlo	 e k s t e n d e r l o 
extendida	 e k s t e n d i d a 
extendidas	 e k s t e n d i d a s 
extensa	 e k s t e n s a 
extenso	 e k s t e n s o 
exterior	 e k s t e r i o r 
externalizado	 e k s t e r n a l i T a d o 
externas	 e k s t e r n a s 
externos	 e k s t e r n o s 
extiende	 e k s t i e n d e 
extraccion	 e k s t r a k T i o n 
extractor	 e k s t r a k t o r 
extrae	 e k s t r a e 
extraer	 e k s t r a e r 
extraidas	 e k s t r a i d a s 
extraido	 e k s t r a i d o 
extranjeras	 e k s t r a n x e r a s 
extranjero	 e k s t r a n x e r o 
extraño	 e k s t r a N o 
extraordinario	 e k s t r a o r d i n a r i o 
extremadamente	 e k s t r e m a d a m e n t e 
extrema	 e k s t r e m a 
extremos	 e k s t r e m o s 
fab	f a b
fabricantes	 f a b r i k a n t e s 
fabuloso	 f a b u l o s o 
faciles	 f a T i l e s 
facil	f a T i l
facil	 f a T i l 
facilidades	 f a T i l i d a d e s 
facilidad	 f a T i l i d a d 
facilitado	 f a T i l i t a d o 
facilita	 f a T i l i t a 
facilitando	 f a T i l i t a n d o 
facilitan	 f a T i l i t a n 
facilitar	 f a T i l i t a r 
facilitarle	 f a T i l i t a r l e 
faciliten	 f a T i l i t e n 
facilito	 f a T i l i t o 
facilmente	 f a T i l m e n t e 
facto	 f a k t o 
factores	 f a k t o r e s 
factor	 f a k t o r 
facturaciones	f a k t u r a T i o n e s	
facturacion	 f a k t u r a T i o n 
factura	 f a k t u r a 
facturar	 f a k t u r a r 
facultades	 f a k u l t a d e s 
facultad	 f a k u l t a d 
fallando	 f a y a n d o 
fallar	 f a y a r 
fallas	 f a y a s 
fallo	 f a y o 
fallos	 f a y o s 
falso	f a l s o
FALSO	 f a l s o 
falsos	 f a l s o s 
falta	 f a l t a 
faltar	 f a l t a r 
faltarian	 f a l t a r i a n 
familia	 f a m i l i a 
familiar	 f a m i l i a r 
famosa	 f a m o s a 
famosas	 f a m o s a s 
famoso	 f a m o s o 
fans	 f a n s 
fantastico	 f a n t a s t i k o 
fascinado	 f a s T i n a d o 
fase	 f a s e 
fases	 f a s e s 
fast	f a s t
fastidiaba	 f a s t i d i a b a 
fastidiado	 f a s t i d i a d o 
fastidiar	 f a s t i d i a r 
fastidiarme	 f a s t i d i a r m e 
fastidies	 f a s t i d i e s 
fatal	 f a t a l 
favorable	 f a b o r a b l e 
favor	 f a b o r 
favorita	 f a b o r i t a 
favoritos	 f a b o r i t o s 
feature	f i C u r
features	f i C u r s
fecha	 f e C a 
fechas	 f e C a s 
feedback	 f i d b a k 
felicitar	 f e l i T i t a r 
felisa	 f e l i s a 
feliz	 f e l i T 
femenino	 f e m e n i n o 
fenomenal	 f e n o m e n a l 
fenomenos	 f e n o m e n o s 
fermin	 f e r m i n 
festivales	 f e s t i b a l e s 
fiabilidad	 f i a b i l i d a d 
fiable	 f i a b l e 
ficha	 f i C a 
fichas	 f i C a s 
fichero	 f i C e r o 
ficheros	 f i C e r o s 
ficho	 f i C o 
fiel	 f i e l 
figura	 f i g u r a 
figuran	 f i g u r a n 
fijado	 f i x a d o 
fijado	f i x a d o
fija	 f i x a 
fijais	 f i x a i s 
fijamos	 f i x a m o s 
fijando	 f i x a n d o 
fijan	 f i x a n 
fijaos	 f i x a o s 
fijar	 f i x a r 
fijarlo	 f i x a r l o 
fijarnos	 f i x a r n o s 
fijarse	 f i x a r s e 
fijas	 f i x a s 
fijen	 f i x e n 
fijense	f i x e n s e
fijense	 f i x e n s e 
fijo	 f i x o 
filetype	f a i l t a i p
filologo	 f i l o l o g o 
filologos	 f i l o l o g o s 
filosofal	 f i l o s o f a l 
filosofia	 f i l o s o f i a 
filter	f i l t e r
filtramos	 f i l t r a m o s 
filtrar	 f i l t r a r 
filtro	 f i l t r o 
filtros	 f i l t r o s 
finales	 f i n a l e s 
final	 f i n a l 
finalizar	 f i n a l i T a r 
finalmente	 f i n a l m e n t e 
financiacion	 f i n a n T i a T i o n 
financiado	 f i n a n T i a d o 
financia	 f i n a n T i a 
financiamos	 f i n a n T i a m o s 
financiando	 f i n a n T i a n d o 
financiar	 f i n a n T i a r 
financieras	 f i n a n T i e r a s 
financiero	 f i n a n T i e r o 
fines	 f i n e s 
fin	 f i n 
fin	f i n
fino	 f i n o 
firma	 f i r m a 
firme	 f i r m e 
firmes	 f i r m e s 
fiscal	 f i s k a l 
fisica	 f i s i k a 
fisicos	 f i s i k o s 
flash	 f l a s 
flebitis	 f l e b i t i s 
flicker	f l i k e r
flickr	 f l i k e r 
flores	 f l o r e s 
flores	f l o r e s
flor	 f l o r 
flower	f l a u e r
flujo	 f l u x o 
foca	 f o k a 
focalizadas	 f o k a l i T a d a s 
focalizados	 f o k a l i T a d o s 
focalizar	 f o k a l i T a r 
focalizarse	 f o k a l i T a r s e 
focas	 f o k a s 
focus	 f o k u s 
fomentar	 f o m e n t a r 
fondo	 f o n d o 
fondos	 f o n d o s 
foral	 f o r a l 
formacion	 f o r m a T i o n 
formado	 f o r m a d o 
forma	 f o r m a 
formal	 f o r m a l 
formamos	 f o r m a m o s 
forman	 f o r m a n 
formarian	 f o r m a r i a n 
formas	 f o r m a s 
formateo	 f o r m a t e o 
formato	 f o r m a t o 
formatos	 f o r m a t o s 
formula	 f o r m u l a 
formulario	 f o r m u l a r i o 
formularios	 f o r m u l a r i o s 
formulas	 f o r m u l a s 
foro	 f o r o 
foros	 f o r o s 
forrar	 f o R a r 
fortalecer	 f o r t a l e T e r 
fortaleza	 f o r t a l e T a 
fortune	 f o r t u n 
forum	 f o r u m 
foto	 f o t o 
fotografia	f o t o g r a f i a
fotografia	 f o t o g r a f i a 
fotografias	 f o t o g r a f i a s 
fotos	 f o t o s 
four	 f o r 
fox	 f o k s 
fracasa	 f r a k a s a 
fraccion	 f r a k T i o n 
franca	 f r a n k a 
francamente	 f r a n k a m e n t e 
franceses	 f r a n T e s e s 
frances	 f r a n T e s 
francia	 f r a n T i a 
francisco	 f r a n T i s k o 
francofono	 f r a n k o f o n o 
frase	 f r a s e 
frases	 f r a s e s 
frecuencia	 f r e k u e n T i a 
frecuencias	 f r e k u e n T i a s 
frecuente	 f r e k u e n t e 
frecuentes	 f r e k u e n t e s 
frecuentisima	 f r e k u e n t i s i m a 
frenar	 f r e n a r 
freno	 f r e n o 
frente	 f r e n t e 
from	f r o m
frontal	 f r o n t a l 
frontera	 f r o n t e r a 
frustracion	 f r u s t r a T i o n 
fruto	 f r u t o 
fue	 f u e 
fuenlabrada	 f u e n l a b r a d a 
fuente	 f u e n t e 
fuentes	 f u e n t e s 
fuera	 f u e r a 
fueran	 f u e r a n 
fueron	 f u e r o n 
fuerte	 f u e r t e 
fuerza	 f u e r T a 
fuese	 f u e s e 
fuesen	 f u e s e n 
fuimos	 f u i m o s 
fulanito	 f u l a n i t o 
fulano	 f u l a n o 
fulgurante	 f u l g u r a n t e 
full	f u l
fullmetal	f u l m e t a l
funcionaba	 f u n T i o n a b a 
funcionaban	 f u n T i o n a b a n 
funcionaban	f u n T i o n a b a n
funciona	 f u n T i o n a 
funcionalidades	 f u n T i o n a l i d a d e s 
funcionalidad	 f u n T i o n a l i d a d 
funcionamiento	 f u n T i o n a m i e n t o 
funcionamos	 f u n T i o n a m o s 
funcionando	 f u n T i o n a n d o 
funcionando	f u n T i o n a n d o
funcionan	 f u n T i o n a n 
funcionara	 f u n T i o n a r a 
funcionaran	 f u n T i o n a r a n 
funcionar	 f u n T i o n a r 
funcionario	 f u n T i o n a r i o 
funcione	 f u n T i o n e 
funciono	f u n T i o n o
funciono	 f u n T i o n o 
fundaciones	 f u n d a T i o n e s 
fundacion	 f u n d a T i o n 
fundadas	 f u n d a d a s 
fundador	 f u n d a d o r 
fundamentales	 f u n d a m e n t a l e s 
fundamental	 f u n d a m e n t a l 
fundamentalmente	 f u n d a m e n t a l m e n t e 
fundetec	 f u n d e t e k 
fundo	 f u n d o 
fusionamos	 f u s i o n a m o s 
fusiones	 f u s i o n e s 
futuras	 f u t u r a s 
futuristas	 f u t u r i s t a s 
futuro	 f u t u r o 
galaxia	 g a l a k s i a 
galery	g a l e r i
gales	 g a l e s 
galicia	 g a l i T i a 
gallego	 g a y e g o 
ganaban	 g a n a b a n 
ganado	 g a n a d o 
gana	 g a n a 
ganamos	 g a n a m o s 
ganando	 g a n a n d o 
ganar	 g a n a r 
ganarlos	 g a n a r l o s 
ganaron	 g a n a r o n 
ganas	 g a n a s 
gap	g a p
garantias	 g a r a n t i a s 
garantiza	 g a r a n t i T a 
garantizar	 g a r a n t i T a r 
garcia	 g a r T i a 
garete	 g a r e t e 
garner	 g a r n e r 
garzon	 g a r T o n 
gas	 g a s 
gasolina	 g a s o l i n a 
gastan	 g a s t a n 
gastar	 g a s t a r 
gastaron	 g a s t a r o n 
gastarse	 g a s t a r s e 
gasto	 g a s t o 
gaudi	 g a u d i 
generaciones	 x e n e r a T i o n e s 
generacion	 x e n e r a T i o n 
generadas	 x e n e r a d a s 
generada	 x e n e r a d a 
generados	 x e n e r a d o s 
generado	 x e n e r a d o 
generales	 x e n e r a l e s 
generalitat	 x e n e r a l i t a t 
generalizacion	x e n e r a l i T a T i o n 
generalizacion	 x e n e r a l i T a T i o n 
generalizamos	 x e n e r a l i T a m o s 
generalizar	 x e n e r a l i T a r 
generalmente	 x e n e r a l m e n t e 
general	 x e n e r a l 
general	x e n e r a l
generamos	 x e n e r a m o s 
generando	 x e n e r a n d o 
generan	 x e n e r a n 
generar	 x e n e r a r 
genera	 x e n e r a 
generen	 x e n e r e n 
genere	 x e n e r e 
genericas	 x e n e r i k a s 
generica	 x e n e r i k a 
genericos	 x e n e r i k o s 
generico	 x e n e r i k o 
genial	 x e n i a l 
gente	 x e n t e 
geograficas	 x e o g r a f i k a s 
geografica	 x e o g r a f i k a 
geografico	 x e o g r a f i k o 
geologia	 x e o l o x i a 
geometrias	 x e o m e t r i a s 
geopolitico	 x e o p o l i t i k o 
geoposicionar	 x e o p o s i T i o n a r 
gerencia	 x e r e n T i a 
gerentes	 x e r e n t e s 
gerente	 x e r e n t e 
gestionar	 x e s t i o n a r 
gestiona	 x e s t i o n a 
gestiones	 x e s t i o n e s 
gestion	x e s t i o n
gestion	 x e s t i o n 
gestores	 x e s t o r e s 
ge	 x e 
gialle	x i a l
gigablast	x i g a b l a s t
gigantesca	 x i g a n t e s k a 
gigante	 x i g a n t e 
girar	 x i r a r 
give	g i f
globales	 g l o b a l e s 
global	 g l o b a l 
globalmente	 g l o b a l m e n t e 
gmail	 x e m e i l 
gobierno	 g o b i e r n o 
gomez	 g o m e T 
google	 g u g e l 
gordas	 g o r d a s 
gordo	 g o r d o 
goverment	g o b e r m e n t
gozamos	 g o T a m o s 
gphone	y i f o n
gps	x e p e e s e
grabame	 g r a b a m e 
grabando	 g r a b a n d o 
grabar	 g r a b a r 
gracia	 g r a T i a 
gracias	 g r a T i a s 
grado	 g r a d o 
grafica	 g r a f i k a 
grafico	g r a f i c o
grafico	 g r a f i k o 
grama	 g r a m a 
gramaticales	 g r a m a t i k a l e s 
gramatical	 g r a m a t i k a l 
granada	 g r a n a d a 
grande	 g r a n d e 
grandes	 g r a n d e s 
grandillas	 g r a n d i y a s 
gran	 g r a n 
gran	g r a n
grano	 g r a n o 
grass	g r a s
gratuita	 g r a t u i t a 
gratuito	 g r a t u i t o 
grave	 g r a b e 
gravisimo	 g r a b i s i m o 
grueso	 g r u e s o 
grupo	 g r u p o 
grupos	 g r u p o s 
guapa	 g u a p a 
guapo	 g u a p o 
guarda	 g u a r d a 
guardar	 g u a r d a r 
guau	 g u a u 
guiada	 g i a d a 
guiado	 g i a d o 
guiar	 g i a r 
guipuzcoa	 g i p u T k o a 
guitarra	 g i t a R a 
gustaba	 g u s t a b a 
gusta	 g u s t a 
gustan	 g u s t a n 
gustaria	 g u s t a r i a 
gustos	 g u s t o s 
h1	a C e u n o
h2	a C e d o s
ha	 a 
habeis	 a b e i s 
haber	 a b e r 
haberla	 a b e r l a 
haberlo	 a b e r l o 
habernos	 a b e r n o s 
habia	a b i a
habia	 a b i a 
habiamos	a b i a m o s
habiamos	 a b i a m o s 
habian	a b i a n
habian	 a b i a n 
habido	 a b i d o 
habiendo	 a b i e n d o 
habilidad	 a b i l i d a d 
habilidades	 a b i l i d a d e s 
habitual	 a b i t u a l 
habitualmente	 a b i t u a l m e n t e 
habla	 a b l a 
hablabamos	 a b l a b a m o s 
hablaban	 a b l a b a n 
hablabas	 a b l a b a s 
hablado	 a b l a d o 
hablais	 a b l a i s 
hablamos	 a b l a m o s 
hablan	 a b l a n 
hablando	 a b l a n d o 
hablantes	 a b l a n t e s 
hablar	 a b l a r 
hablarais	 a b l a r a i s 
hablare	 a b l a r e 
hablaremos	 a b l a r e m o s 
hablarle	 a b l a r l e 
hablarlo	 a b l a r l o 
hablarme	 a b l a r m e 
hablaros	 a b l a r o s 
hablas	 a b l a s 
hable	 a b l e 
hable	 a b l e 
hablemos	 a b l e m o s 
hablen	 a b l e n 
hablo	 a b l o 
hablo	 a b l o 
habra	a b r a
habra	 a b r a 
habran	a b r a n
habran	 a b r a n 
habria	a b r i a
habria	 a b r i a 
hace	 a T e 
hacemos	 a T e m o s 
hacen	 a T e n 
hacer	 a T e r 
hacerla	 a T e r l a 
hacerlo	 a T e r l o 
hacerse	 a T e r s e 
hacerte	 a T e r t e 
haces	 a T e s 
hacia	 a T i a 
hacia	 a T i a 
haciais	 a T i a i s 
haciamos	a T i a m o s
haciamos	 a T i a m o s 
hacian	 a T i a n 
hacias	 a T i a s 
haciendo	 a T i e n d o 
haciendole	 a T i e n d o l e 
haciendolo	 a T i e n d o l o 
haga	 a g a 
hagais	 a g a i s 
hagamos	 a g a m o s 
hagan	 a g a n 
hago	 a g o 
hala	 a l a 
hallazgos	 a y a T g o s 
hambre	 a m b r e 
han	 a n 
handicap	 h a n d i k a p 
haran	 a r a n 
hardware	 h a r d g u a r 
haremos	 a r e m o s 
haria	 a r i a 
harry	 h e R i 
harto	 a r t o 
harvard	 h a r b a r d 
has	 a s 
hasta	 a s t a 
haya	 a y a 
hay	 a i 
hayamos	 a y a m o s 
hayan	 a y a n 
haz	 a T 
hecha	 e C a 
hechas	 e C a s 
hecho	 e C o 
hecho	e C o
hechos	 e C o s 
he	 e 
hemos	 e m o s 
henares	 e n a r e s 
heroico	 e r o i k o 
herramienta	 e R a m i e n t a 
herramientas	 e R a m i e n t a s 
heterogeneos	 e t e r o x e n e o s 
heuristica	e u r i s t i k a
heuristica	 e u r i s t i k a 
hice	 i T e 
hiciera	 i T i e r a 
hicieramos	 i T i e r a m o s 
hicieran	 i T i e r a n 
hicieron	 i T i e r o n 
hiciese	 i T i e s e 
hicimos	 i T i m o s 
hierba	 i e r b a 
hierbas	 i e r b a s 
hijo	 i x o 
hilos	 i l o s 
hindues	 i n d u e s 
hipertextuales	 i p e r t e k s t u a l e s 
hipertextual	 i p e r t e k s t u a l 
hipervinculos	 i p e r b i n k u l o s 
hipotesis	i p o t e s i s
hipotesis	 i p o t e s i s 
hispana	 i s p a n a 
hispanica	 i s p a n i k a 
hispanohablantes	 i s p a n o a b l a n t e s 
histograma	 i s t o g r a m a 
histogramas	 i s t o g r a m a s 
historia	 i s t o r i a 
historiales	 i s t o r i a l e s 
historial	 i s t o r i a l 
historias	 i s t o r i a s 
hits	 h i t s 
hizo	 i T o 
hl7	a C e e l e s i e t e
hoc	 o k 
hoja	 o x a 
hojas	 o x a s 
holanda	 o l a n d a 
holandes	 o l a n d e s 
hola	 o l a 
hollies	 h o l i s 
hombre	 o m b r e 
homer	 h o m e r 
homogenea	 o m o x e n e a 
homogeneizar	 o m o x e n e i T a r 
homologadas	 o m o l o g a d a s 
homologados	 o m o l o g a d o s 
homologan	 o m o l o g a n 
homosexual	 o m o s e k s u a l 
honor	 o n o r 
hora	 o r a 
horario	 o r a r i o 
horas	 o r a s 
horizontal	 o r i T o n t a l 
horizonte	 o r i T o n t e 
horrorosa	 o R o r o s a 
hospitales	 o s p i t a l e s 
hospital	 o s p i t a l 
hostilidad	 o s t i l i d a d 
hoteles	 o t e l e s 
hoy	 o i 
hp	a C e p e
hpux	a C e p u k s
html	a C e t e e m e e l e
http	a C e t e t e p e
hubieramos	 u b i e r a m o s 
hubieramos	 u b i e r a m o s 
hubieran	 u b i e r a n 
hubiera	 u b i e r a 
hubiesen	 u b i e s e n 
hubiesen	u b i e s e n
hubiese	 u b i e s e 
hubo	 u b o 
hueco	 u e k o 
huelva	 u e l b a 
humanas	 u m a n a s 
humanidades	 u m a n i d a d e s 
humanisticos	 u m a n i s t i k o s 
humanos	 u m a n o s 
humano	 u m a n o 
hundira	 u n d i r a 
hungaros	u n g a r o s
hungaros	 u n g a r o s 
huy	 u i 
iba	 i b a 
ibamos	i b a m o s
ibamos	 i b a m o s 
iberica	 i b e r i k a 
iberoamericanas	 i b e r o a m e r i k a n a s 
ibm	i b e e m e
ibn	i n e e n e
iclef	i T e e l e e f e
icono	 i k o n o 
iconos	 i k o n o s 
idea	 i d e a 
ideal	 i d e a l 
ideas	 i d e a s 
identicas	 i d e n t i k a s 
identico	 i d e n t i k o 
identicos	 i d e n t i k o s 
identificable	 i d e n t i f i k a b l e 
identificado	 i d e n t i f i k a d o 
identifica	 i d e n t i f i k a 
identificar	 i d e n t i f i k a r 
identificarse	 i d e n t i f i k a r s e 
id	i d
idilio	 i d i l i o 
idioma	 i d i o m a 
idiomas	 i d i o m a s 
idiomatico	 i d i o m a t i k o 
idiomaticos	 i d i o m a t i k o s 
ido	 i d o 
idomas	 i d o m a s 
iglesias	 i g l e s i a s 
ignorando	 i g n o r a n d o 
igualacion	 i g u a l a T i o n 
iguales	 i g u a l e s 
igual	 i g u a l 
igualmente	 i g u a l m e n t e 
i	 i 
iii	i i i
ikea	 i k e a 
ilegal	 i l e g a l 
iluminacion	i l u m i n a T i o n
iluminacion	 i l u m i n a T i o n 
ilustraciones	 i l u s t r a T i o n e s 
ilustrar	 i l u s t r a r 
image	 e m i C 
imagenes	i m a x e n e s
imagenes	 i m a x e n e s 
imagen	 i m a x e n 
images	 e m i C e s
imaginais	i m a x i n a i s
imaginais	 i m a x i n a i s 
imaginaos	 i m a x i n a o s 
imaginar	 i m a x i n a r 
imaginaros	 i m a x i n a r o s 
imaginate	 i m a x i n a t e 
imaginense	 i m a x i n e n s e 
imaginense	i m a x i n e se 
imagino	 i m a x i n o 
imbricacion	 i m b r i k a T i o n 
impacto	 i m p a k t o 
imparte	 i m p a r t e 
impepinable	 i m p e p i n a b l e 
imperio	 i m p e r i o 
impide	 i m p i d e 
impiden	 i m p i d e n 
implantacion	 i m p l a n t a T i o n 
implantar	 i m p l a n t a r 
implementacion	 i m p l e m e n t a T i o n 
implementado	 i m p l e m e n t a d o 
implementamos	 i m p l e m e n t a m o s 
implicacion	 i m p l i k a T i o n 
implicada	 i m p l i k a d a 
implicadas	 i m p l i k a d a s 
implicados	 i m p l i k a d o s 
implica	 i m p l i k a 
implicaria	 i m p l i k a r i a 
implicar	 i m p l i k a r 
implicase	 i m p l i k a s e 
implique	 i m p l i k e 
imponderables	 i m p o n d e r a b l e s 
imponiendo	 i m p o n i e n d o 
importa	 i m p o r t a 
importancia	 i m p o r t a n T i a 
importante	 i m p o r t a n t e 
importantes	 i m p o r t a n t e s 
importantisimo	 i m p o r t a n t i s i m o 
imposibilidad	 i m p o s i b i l i d a d 
imposible	 i m p o s i b l e 
impresionante	 i m p r e s i o n a n t e 
impresion	i m p r e s i o n
impresion	 i m p r e s i o n 
impreso	 i m p r e s o 
imprimir	 i m p r i m i r 
improvisara	 i m p r o b i s a r a 
impuestos	 i m p u e s t o s 
impulsando	 i m p u l s a n d o 
impulsar	 i m p u l s a r 
inaccesible	 i n a k T e s i b l e 
iñaki	 i N a k i 
incapacidad	 i n k a p a T i d a d 
incentivar	 i n T e n t i b a r 
inciativa	 i n T i a t i b a 
incidencias	 i n T i d e n T i a s 
incidiendo	 i n T i d i e n d o 
incidir	 i n T i d i r 
incluido	 i n k l u i d o 
incluidos	 i n k l u i d o s 
incluimos	 i n k l u i m o s 
incluir	 i n k l u i r 
incluso	 i n k l u s o 
incluyan	 i n k l u y a n 
incluye	 i n k l u y e 
incluyendo	 i n k l u y e n d o 
incluyera	 i n k l u y e r a 
incoherencia	 i n k o e r e n T i a 
incompleta	 i n k o m p l e t a 
incontrolado	 i n k o n t r o l a d o 
inconveniente	 i n k o m b e n i e n t e 
inconvenientes	 i n k o m b e n i e n t e s 
incorporacion	 i n k o r p o r a T i o n 
incorporado	 i n k o r p o r a d o 
incorpora	 i n k o r p o r a 
incorporamos	 i n k o r p o r a m o s 
incorporando	 i n k o r p o r a n d o 
incorporar	 i n k o r p o r a r 
incorporarlo	 i n k o r p o r a r l o 
incorporas	 i n k o r p o r a s 
incorporen	 i n k o r p o r e n 
incorrecta	 i n k o R e k t a 
incorrectas	 i n k o R e k t a s 
increible	 i n k r e i b l e 
increiblemente	 i n k r e i b l e m e n t e 
incrementa	 i n k r e m e n t a 
incrementan	 i n k r e m e n t a n 
incrementar	 i n k r e m e n t a r 
incrementen	 i n k r e m e n t e n 
incremento	 i n k r e m e n t o 
incubadora	 i n k u b a d o r a 
incursiones	 i n k u r s i o n e s 
indagar	 i n d a g a r 
independiente	 i n d e p e n d i e n t e 
independientemente	 i n d e p e n d i e n t e m e n t e 
independientes	 i n d e p e n d i e n t e s 
indexaciones	i n d e k s a T i o n
indexaciones	 i n d e k s a T i o n e s 
indexacion	i n d e k s a T i o n
indexacion	 i n d e k s a T i o n 
indexado	 i n d e k s a d o 
indexadores	 i n d e k s a d o r e s 
indexador	 i n d e k s a d o r 
indexados	 i n d e k s a d o s 
indexa	 i n d e k s a 
indexando	 i n d e k s a n d o 
indexan	 i n d e k s a n 
indexar	 i n d e k s a r 
index	i n d e k s
indexing	i n d e k s i n g
india	 i n d i a 
indicaba	 i n d i k a b a 
indicacion	 i n d i k a T i o n 
indicadores	 i n d i k a d o r e s 
indicador	 i n d i k a d o r 
indica	 i n d i k a 
indicamos	 i n d i k a m o s 
indicando	 i n d i k a n d o 
indican	 i n d i k a n 
indicar	 i n d i k a r 
indice	 i n d i T e 
indices	 i n d i T e s 
indico	 i n d i k o 
indirecta	 i n d i r e k t a 
indirectamente	 i n d i r e k t a m e n t e 
indirectos	 i n d i r e k t o s 
indiscutible	 i n d i s k u t i b l e 
individual	 i n d i b i d u a l 
indizacion	 i n d i T a T i o n 
indizada	 i n d i T a d a 
indizados	 i n d i T a d o s 
indizar	 i n d i T a r 
indra	 i n d r a 
industria	 i n d u s t r i a 
industrial	 i n d u s t r i a l 
inesperado	 i n e s p e r a d o 
inevitable	 i n e b i t a b l e 
inexplorados	 i n e k s p l o r a d o s 
infantil	 i n f a n t i l 
infarto	 i n f a r t o 
infecciones	 i n f e k T i o n e s 
inferior	 i n f e r i o r 
influir	 i n f l u i r 
influye	 i n f l u y e 
info	 i n f o 
informaciones	 i n f o r m a T i o n e s 
informacion	i n f o r m a T i o n
informacion	 i n f o r m a T i o n 
informada	 i n f o r m a d a 
informado	 i n f o r m a d o 
informal	 i n f o r m a l 
informatica	 i n f o r m a t i k a 
informaticas	 i n f o r m a t i k a s 
informatico	 i n f o r m a t i k o 
informaticos	 i n f o r m a t i k o s 
information	 i n f o r m e i s i o n 
informe	 i n f o r m e 
informes	 i n f o r m e s 
infraestructuras	 i n f r a e s t r u k t u r a s 
infumable	 i n f u m a b l e 
ingenieria	 i n x e n i e r i a 
ingeniero	 i n x e n i e r o 
ingenieros	 i n x e n i e r o s 
inglaterra	 i n g l a t e R a 
inglesa	 i n g l e s a 
ingleses	 i n g l e s e s 
ingles	i n g l e s
ingles	 i n g l e s 
ingresos	 i n g r e s o s 
inherentemente	 i n e r e n t e m e n t e 
iniciales	 i n i T i a l e s 
inicial	 i n i T i a l 
inicialmente	 i n i T i a l m e n t e 
iniciativa	 i n i T i a t i b a 
iniciativas	 i n i T i a t i b a s 
inmadurez	 i n m a d u r e T 
inmediatamente	 i n m e d i a t a m e n t e 
inmensa	 i n m e n s a 
innovacion	 i n n o b a T i o n 
innovadores	 i n n o b a d o r e s 
innovador	 i n n o b a d o r 
innovar	 i n n o b a r 
inside	 i n s a i d 
insisto	 i n s i s t o 
instalable	 i n s t a l a b l e 
instalacion	i n s t a l a T i o n
instalacion	 i n s t a l a T i o n 
instala	 i n s t a l a 
instalamos	 i n s t a l a m o s 
instalar	 i n s t a l a r 
instalarlo	 i n s t a l a r l o 
instanciando	 i n s t a n T i a n d o 
instancian	 i n s t a n T i a n 
instantaneo	 i n s t a n t a n e o 
institucionales	 i n s t i t u T i o n a l e s 
institucional	 i n s t i t u T i o n a l 
instituciones	 i n s t i t u T i o n e s 
institucion	 i n s t i t u T i o n 
instituto	 i n s t i t u t o 
institutos	 i n s t i t u t o s 
instrumento	 i n s t r u m e n t o 
instrumentos	 i n s t r u m e n t o s 
intangibles	 i n t a n x i b l e s 
integracion	 i n t e g r a T i o n 
integrado	 i n t e g r a d o 
integrados	 i n t e g r a d o s 
integramos	 i n t e g r a m o s 
integrar	 i n t e g r a r 
integrarlo	 i n t e g r a r l o 
intelectual	 i n t e l e k t u a l 
inteligencia	 i n t e l i x e n T i a 
inteligente	 i n t e l i x e n t e 
inteligentes	 i n t e l i x e n t e s 
intencion	 i n t e n T i o n 
intensiva	 i n t e n s i b a 
intentad	 i n t e n t a d 
intenta	 i n t e n t a 
intentamos	 i n t e n t a m o s 
intentando	 i n t e n t a n d o 
intentan	 i n t e n t a n 
intentare	 i n t e n t a r e 
intentaremos	 i n t e n t a r e m o s 
intentar	 i n t e n t a r 
intentaron	 i n t e n t a r o n 
intentas	 i n t e n t a s 
interaccionar	 i n t e r a k T i o n a r 
interacciones	 i n t e r a k T i o n e s 
interaccion	 i n t e r a k T i o n 
interactiva	 i n t e r a k t i b a 
interactivo	 i n t e r a k t i b o 
interactivos	 i n t e r a k t i b o s 
intercambiar	 i n t e r k a m b i a r 
intercambio	 i n t e r k a m b i o 
interceptadas	 i n t e r T e p t a d a s 
interesaba	 i n t e r e s a b a 
interesaba	i n t e r e s a b a
interesada	 i n t e r e s a d a 
interesadas	 i n t e r e s a d a s 
interesados	 i n t e r e s a d o s 
interesa	 i n t e r e s a 
interesando	 i n t e r e s a n d o 
interesan	 i n t e r e s a n 
interesante	 i n t e r e s a n t e 
interesantes	 i n t e r e s a n t e s 
interesaria	 i n t e r e s a r i a 
interesar	 i n t e r e s a r 
interesarte	 i n t e r e s a r t e 
interesen	 i n t e r e s e n 
intereses	 i n t e r e s e s 
interes	 i n t e r e s 
intereso	 i n t e r e s o 
interface	 i n t e r f e i s 
interfaces	 i n t e r f e i s 
interfaz	 i n t e r f a T 
intermediacion	 i n t e r m e d i a T i o n 
intermediarios	 i n t e r m e d i a r i o s 
intermedio	 i n t e r m e d i o 
internacionales	 i n t e r n a T i o n a l e s 
internacional	 i n t e r n a T i o n a l 
internacionalizandose	 i n t e r n a T i o n a l i T a n d o s e 
internacionalmente	 i n t e r n a T i o n a l m e n t e 
interna	 i n t e r n a 
internauta	 i n t e r n a u t a 
internautas	 i n t e r n a u t a s 
internet	 i n t e r n e t 
interpretacion	 i n t e r p r e t a T i o n 
interpretadas	 i n t e r p r e t a d a s 
interpretar	 i n t e r p r e t a r 
interrelacionadas	 i n t e R e l a T i o n a d a s 
interrelacionado	 i n t e R e l a T i o n a d o 
interrelaciona	 i n t e R e l a T i o n a 
interrogantes	 i n t e R o g a n t e s 
interrogar	 i n t e R o g a r 
interroguemos	 i n t e R o g e m o s 
interrumpimos	 i n t e R u m p i m o s 
interseccion	 i n t e r s e k T i o n 
intervalo	 i n t e r b a l o 
intervalos	 i n t e r b a l o s 
intervencion	 i n t e r b e n T i o n 
intervenir	 i n t e r b e n i r 
introduccion	 i n t r o d u k T i o n 
introducido	 i n t r o d u T i d o 
introduciendo	 i n t r o d u T i e n d o 
introducir	 i n t r o d u T i r 
introduzca	 i n t r o d u T k a 
introduzcan	 i n t r o d u T k a n 
intuicion	 i n t u i T i o n 
intuir	 i n t u i r 
inutiles	 i n u t i l e s 
inutil	 i n u t i l 
inventamos	 i m b e n t a m o s 
inventar	 i m b e n t a r 
inversa	 i m b e r s a 
inversion	 i m b e r s i o n 
inversores	 i m b e r s o r e s 
invertido	 i m b e r t i d o 
invertir	 i m b e r t i r 
investigaciones	 i m b e s t i g a T i o n e s 
investigacion	 i m b e s t i g a T i o n 
investigacion	i n b e s t i g a T i o n
investigadora	 i m b e s t i g a d o r a 
investigadores	 i m b e s t i g a d o r e s 
investigador	 i m b e s t i g a d o r 
investiga	 i m b e s t i g a 
investigando	 i m b e s t i g a n d o 
investigar	 i m b e s t i g a r 
investigarlo	 i m b e s t i g a r l o 
inviable	 i n b i a b l e 
invierte	 i m b i e r t e 
invierten	 i m b i e r t e n 
invisible	 i m b i s i b l e 
invitado	 i m b i t a d o 
invita	 i m b i t a 
invitarme	 i m b i t a r m e 
invitarnos	 i m b i t a r n o s 
invite	i m b a i t
invito	 i m b i t o 
involucrada	 i m b o l u k r a d a 
involucradas	 i m b o l u k r a d a s 
involucrados	 i m b o l u k r a d o s 
ipod	 a i p o d 
irazabalbeitia	 i r a T a b a l b e i t i a 
iremos	 i r e m o s 
iria	 i r i a 
ir	 i r 
irlanda	 i r l a n d a 
irlos	 i r l o s 
irrelevante	 i R e l e b a n t e 
irse	 i r s e 
isabel	 i s a b e l 
isidro	 i s i d r o 
isoco	 i s o k o 
israel	 i s R a e l 
italia	 i t a l i a 
italiana	 i t a l i a n a 
italiano	 i t a l i a n o 
italianos	 i t a l i a n o s 
iteraciones	 i t e r a T i o n e s 
iterativo	 i t e r a t i b o 
ixa	 i k s a 
izquierda	 i T k i e r d a 
izquierdo	 i T k i e r d o 
jaldun	 x a l d u n 
japonesas	 x a p o n e s a s 
japoneses	 x a p o n e s e s 
japones	 x a p o n e s 
japon	 x a p o n 
javascript	 x a b a e s k r i p 
java	 x a b a 
jazztel	 r a s t e l 
jefe	 x e f e 
jerarquias	 x e r a r k i a s 
jerarquia	 x e r a r k i a 
jerarquica	x e r a r k i k a
jerarquica	 x e r a r k i k a 
jerarquizadas	 x e r a r k i T a d a s 
jesus	 x e s u s 
je	 x e 
joder	 x o d e r 
jodido	 x o d i d o 
jope	 x o p e 
jornadas	 x o r n a d a s 
jornada	 x o r n a d a 
jose	 x o s e 
jose	 x o s e 
jovenes	 x o b e n e s 
joven	 x o b e n 
jubilacion	 x u b i l a T i o n 
juegan	 x u e g a n 
juegos	 x u e g o s 
juego	 x u e g o 
jugador	 x u g a d o r 
jugando	 x u g a n d o 
jugarse	 x u g a r s e 
jugar	 x u g a r 
juicios	 x u i T i o s 
juicio	 x u i T i o 
julio	 x u l i o 
juntas	 x u n t a s 
juntos	 x u n t o s 
junto	 x u n t o 
jurado	 x u r a d o 
justamente	 x u s t a m e n t e 
justificacion	 x u s t i f i k a T i o n 
justificar	 x u s t i f i k a r 
justo	 x u s t o 
keyword	k i u o r d
keywords	k i u o r d s
killer	k i l e r
kilometros	 k i l o m e t r o s 
kutxa	 k u C a 
la2	e l e a d o s
laberinto	 l a b e r i n t o 
lab	 l a b 
laboratorio	 l a b o r a t o r i o 
laborda	 l a b o r d a 
labor	 l a b o r 
lado	 l a d o 
ladrones	 l a d r o n e s 
lago	 l a g o 
la	 l a 
la	l a
lamadas	 l a m a d a s 
lamentablemente	 l a m e n t a b l e m e n t e 
language	l an g u i C
lanza	 l a n T a 
lanzamiento	 l a n T a m i e n t o 
lanzan	 l a n T a n 
lanzar	 l a n T a r 
lanzarlas	 l a n T a r l a s 
larga	 l a r g a 
largamente	 l a r g a m e n t e 
largo	 l a r g o 
larguisima	 l a r g i s i m a 
larry	 l a e R i 
las	 l a s 
lastre	 l a s t r e 
latina	 l a t i n a 
latinoamerica	 l a t i n o a m e r i k a 
latinoamericano	 l a t i n o a m e r i k a n o 
latino	 l a t i n o 
leader	l i d e r
learning	l e r n i n g	
lecciones	 l e k T i o n e s 
lectores	 l e k t o r e s 
leerla	 l e e r l a 
leer	 l e e r 
leernos	 l e e r n o s 
legales	 l e g a l e s 
leia	 l e i a 
leido	 l e i d o 
leitmotiv	 l e i t m o t i b 
lejana	 l e x a n a 
lejos	 l e x o s 
le	 l e 
le	l e
lemas	 l e m a s 
lenguaje	 l e n g u a x e 
lengua	 l e n g u a 
lenguas	 l e n g u a s 
lentamente	 l e n t a m e n t e 
lento	 l e n t o 
leon	 l e o n 
les	 l e s 
letra	 l e t r a 
letrero	 l e t r e r o 
levantad	 l e b a n t a d 
levanta	 l e b a n t a 
lexica	 l e k s i k a 
lexico	 l e k s i k o 
leyendo	 l e y e n d o 
leyes	 l e y e s 
ley	 l e i 
liberado	 l i b e r a d o 
liberalizo	 l i b e r a l i T o 
liberar	 l i b e r a r 
liberas	 l i b e r a s 
libertad	 l i b e r t a d 
lib	 l i b 
library	l a i b r e r i
libre	 l i b r e 
libreria	 l i b r e r i a 
librerias	 l i b r e r i a s 
libres	 l i b r e s 
libro	 l i b r o 
libros	 l i b r o s 
licenciados	 l i T e n T i a d o s 
licenciarlo	 l i T e n T i a r l o 
lideres	 l i d e r e s 
lider	 l i d e r 
lidiar	 l i d i a r 
ligadas	 l i g a d a s 
ligado	 l i g a d o 
ligeramente	 l i x e r a m e n t e 
limitaciones	 l i m i t a T i o n e s 
limitacion	 l i m i t a T i o n 
limitados	 l i m i t a d o s 
limite	 l i m i t e 
limpiando	 l i m p i a n d o 
linca	 l i n k a 
linea	 l i n e a 
lineas	 l i n e a s 
lingüista	 l i n g u i s t a 
lingüistas	 l i n g u i s t a s 
lingüistica	l i n g u i s t i k a
lingüistica	 l i n g u i s t i k a 
lingüisticas	l i n g u i s t i k a
lingüisticas	 l i n g u i s t i k a s 
lingüistico	 l i n g u i s t i k o 
lingüisticos	 l i n g u i s t i k o s 
linka	l i n k a
link	 l i n k 
links	 l i n k s 
linux	 l i n u k s 
listado	 l i s t a d o 
listados	 l i s t a d o s 
lista	 l i s t a 
listo	 l i s t o 
listos	 l i s t o s 
literal	 l i t e r a l 
live	l a i f
llamaba	 y a m a b a 
llamadas	 y a m a d a s 
llamada	 y a m a d a 
llamado	 y a m a d o 
llamamos	 y a m a m o s 
llamando	 y a m a n d o 
llaman	 y a m a n 
llaman	y a m a n
llamarla	 y a m a r l a 
llamarlo	 y a m a r l o 
llamaron	 y a m a r o n 
llamar	 y a m a r 
llamas	 y a m a s 
llamativos	 y a m a t i b o s 
llama	 y a m a 
llame	 y a m e 
llamo	 y a m o 
llavecita	 y a b e T i t a 
llegaba	 y e g a b a 
llegada	 y e g a d a 
llegado	 y e g a d o 
llegado	y e g a n d o
llegamos	 y e g a m o s 
llegando	 y e g a n d o 
llegan	 y e g a n 
llegar	 y e g a r 
llega	 y e g a 
llegue	 y e g e 
llegue	 y e g e 
llenarlo	 y e n a r l o 
llenguatge	y e n g u a C
lleno	 y e n o 
llevado	 y e b a d o 
llevamos	 y e b a m o s 
llevando	 y e b a n d o 
llevan	 y e b a n 
llevar	 y e b a r 
llevas	 y e b a s 
lleva	 y e b a 
lleven	 y e b e n 
llevo	 y e b o 
lobotomizar	 l o b o t o m i T a r 
locales	 l o k a l e s 
localidad	 l o k a l i d a d 
localizaciones	 l o k a l i T a T i o n e s 
localizacion	 l o k a l i T a T i o n 
localizada	 l o k a l i T a d a 
localizador	 l o k a l i T a d o r 
localizados	 l o k a l i T a d o s 
localizar	 l o k a l i T a r 
localizarse	 l o k a l i T a r s e 
localizas	 l o k a l i T a s 
local	 l o k a l 
locos	 l o k o s 
logaritmico	 l o g a r i t m i k o 
logica	l o x i k a
logica	 l o x i k a 
logicamente	 l o x i k a m e n t e 
logicas	 l o x i k a s 
logico	l o x i k o 
logico	 l o x i k o 
login	 l a g i n 
logo	 l o g o 
logotipo	 l o g o t i p o 
logrado	 l o g r a d o 
logrando	 l o g r a n d o 
logran	 l o g r a n 
lograr	 l o g r a r 
logren	 l o g r e n 
logro	 l o g r o 
logs	l o g s
lo	 l o 
lo	l o
londres	 l o n d r e s 
longitud	 l o n x i t u d 
long	l o n g s
los	 l o s 
louvre	 l u b r e 
lucha	 l u C a 
luchar	 l u C a r 
luego	 l u e g o 
lugares	 l u g a r e s 
lugar	 l u g a r 
luis	 l u i s 
luz	 l u T 
machine	m a C i n
madonna	 m a d o n a 
madre	 m a d r e 
madrid	 m a d r i d 
madurado	 m a d u r a d o 
madura	 m a d u r a 
madurar	 m a d u r a r 
madurez	 m a d u r e T 
maduro	 m a d u r o 
ma	e m e a
magallanes	 m a g a y a n e s 
magica	m a x i c a
magica	 m a x i k a 
magicos	 m a x i k o s 
magnifica	 m a g n i f i k a 
magnifico	 m a g n i f i k o 
magnitud	 m a g n i t u d 
magos	 m a g o s 
malaga	 m a l a g a 
mala	 m a l a 
mala	m a l a
malas	 m a l a s 
maldito	 m a l d i t o 
mal	 m a l 
malo	 m a l o 
malos	 m a l o s 
mama	m a m a
mama	 m a m a 
maña	 m a N a 
mañana	 m a N a n a 
manda	 m a n d a 
mandamos	 m a n d a m o s 
mandar	 m a n d a r 
manden	 m a n d e n 
maneja	 m a n e x a 
manejan	 m a n e x a n 
manejar	 m a n e x a r 
manera	 m a n e r a 
maneras	 m a n e r a s 
manfred	 m a n f r e d 
manifiesta	 m a n i f i e s t a 
mann	 m a n 
manolo	 m a n o l o 
mano	 m a n o 
manos	 m a n o s 
mantenerlo	 m a n t e n e r l o 
mantenerlos	 m a n t e n e r l o s 
mantener	 m a n t e n e r 
mantenido	 m a n t e n i d o 
manteniendo	 m a n t e n i e n d o 
manteniendonos	 m a n t e n i e n d o n o s 
mantenimiento	 m a n t e n i m i e n t o 
mantiene	 m a n t i e n e 
mantienen	 m a n t i e n e n 
manual	 m a n u a l 
manualmente	 m a n u a l m e n t e 
manuel	 m a n u e l 
mapeado	 m a p e a d o 
mapita	 m a p i t a 
maps	 m a p s 
maquina	m a k i n a
maquina	 m a k i n a 
maraña	 m a r a N a 
maravillosamente	 m a r a b i y o s a m e n t e 
maravilloso	 m a r a b i y o s o 
marcabas	 m a r k a b a s 
marcado	 m a r k a d o 
marca	 m a r k a 
marcamos	 m a r k a m o s 
marcando	 m a r k a n d o 
marcar	 m a r k a r 
marcas	 m a r k a s 
marcelino	 m a r T e l i n o 
marcha	 m a r C a 
marchamo	 m a r C a m o 
marcin	 m a r T i n 
marco	 m a r k o 
marcos	 m a r k o s 
marcos	m a r k o s
margen	 m a r x e n 
marginales	 m a r x i n a l e s 
maria	 m a r i a 
marido	 m a r i d o 
marketing	 m a r k e t i n 
mar	 m a r 
marriage	m a R i C
marruecos	 m a R u e k o s 
martinez	 m a r t i n e T 
marxista	 m a r s i s t a 
marzo	 m a r T o 
mas	m a s
mas	 m a s 
master	m a s t e r
master	 m a s t e r 
matar	 m a t a r 
matching	m a C i n g
match	m a C
matematica	 m a t e m a t i k a 
matematico	 m a t e m a t i k o 
matematicos	 m a t e m a t i k o s 
materiales	 m a t e r i a l e s 
materializar	 m a t e r i a l i T a r 
material	 m a t e r i a l 
materia	 m a t e r i a 
materias	 m a t e r i a s 
matiz	 m a t i T 
matrimoniales	 m a t r i m o n i a l e s 
matriz	 m a t r i T 
mavir	 m a b i r 
maxima	 m a k s i m a 
maximizar	 m a k s i m i T a r 
maximo	 m a k s i m o 
mayores	 m a y o r e s 
mayoria	m a y o r i a
mayoria	 m a y o r i a 
mayoritario	 m a y o r i t a r i o 
mayor	 m a y o r 
mba	e m b i e i
mbas	e m b i e i s
mccann	 m a c c a n
mecanismo	 m e k a n i s m o 
mecanismos	 m e k a n i s m o s 
media	 m e d i a 
mediante	 m e d i a n t e 
medias	 m e d i a s 
mediaticos	 m e d i a t i k o s 
medica	 m e d i k a 
medicamentos	 m e d i k a m e n t o s 
medicas	 m e d i k a s 
medicina	 m e d i T i n a 
medico	 m e d i k o 
medicos	 m e d i k o s 
medida	 m e d i d a 
medidas	 m e d i d a s 
medido	 m e d i d o 
medioambiente	 m e d i o a m b i e n t e 
mediodia	 m e d i o d i a 
medio	 m e d i o 
medios	 m e d i o s 
medir	 m e d i r 
mejico	 m e x i k o 
mejoraba	 m e x o r a b a 
mejoraba	m e x o r a b a
mejora	 m e x o r a 
mejoramiento	 m e x o r a m i e n t o 
mejoramos	 m e x o r a m o s 
mejorarlo	 m e x o r a r l o 
mejorarlo	m e x o r a r l o
mejorarlos	 m e x o r a r l o s 
mejorar	 m e x o r a r 
mejoras	 m e x o r a s 
mejoren	 m e x o r e n 
mejores	 m e x o r e s 
mejor	 m e x o r 
mejor	m e x o r
mejoro	m e x o r o
mejoro	 m e x o r o 
melbourne	 m e l b u r n e 
me	 m e 
me	m i
memoria	 m e m o r i a 
mencionaba	 m e n T i o n a b a 
mencionaban	 m e n T i o n a b a n 
mencionado	 m e n T i o n a d o 
mencionarlo	 m e n T i o n a r l o 
mencionar	 m e n T i o n a r 
mencion	 m e n T i o n 
menores	 m e n o r e s 
menor	 m e n o r 
menos	 m e n o s 
mensaje	 m e n s a x e 
mensuales	 m e n s u a l e s 
mensual	 m e n s u a l 
mentalidad	 m e n t a l i d a d 
mente	 m e n t e 
mentira	 m e n t i r a 
menudo	 m e n u d o 
meramente	 m e r a m e n t e 
mercado	 m e r k a d o 
mercados	 m e r k a d o s 
mercurio	 m e r k u r i o 
merece	 m e r e T e 
merecia	 m e r e T i a 
mesa	 m e s a 
meses	 m e s e s 
mes	 m e s 
metabuscadores	 m e t a b u s k a d o r e s 
metabuscador	 m e t a b u s k a d o r 
metadatos	 m e t a d a t o s 
metainformacion	 m e t a i n f o r m a T i o n 
metemos	 m e t e m o s 
meter	 m e t e r 
meterse	 m e t e r s e 
metes	 m e t e s 
metiamos	m e t i a m o s
metiamos	 m e t i a m o s 
metido	 m e t i d o 
metiendo	 m e t i e n d o 
metodologia	 m e t o d o l o x i a 
metodologicamente	 m e t o d o l o x i k a m e n t e 
metodologica	 m e t o d o l o x i k a 
metodo	m e t o d o
metodo	 m e t o d o 
metodos	m e t o d o s
metodos	 m e t o d o s 
meto	 m e t o 
metrica	m e t r i k a
metrica	 m e t r i k a 
mexicanos	 m e x i k a n o s 
mezcla	 m e T k l a 
mezclamos	 m e T k l a m o s 
mezclan	 m e T k l a n 
microfono	 m i k r o f o n o 
micro	 m i k r o 
microsoft	 m i k r o s o r
mide	 m i d e 
miden	 m i d e n 
midiendo	 m i d i e n d o 
miedo	 m i e d o 
mienta	 m i e n t a 
miento	 m i e n t o 
mientras	 m i e n t r a s 
mierda	 m i e r d a 
migajas	 m i g a x a s 
miga	 m i g a 
miguel	 m i g e l 
miles	 m i l e s 
miles	m i l e s
millan	 m i y a n 
millonarios	 m i y o n a r i o s 
millones	 m i y o n e s 
millon	 m i y o n 
mil	 m i l 
mimbres	 m i m b r e s 
mi	 m i 
mi	m i 
mi	 m i 
mineria	 m i n e r i a 
minimizar	 m i n i m i T a r 
minimo	 m i n i m o 
mining	m a i n i n g
ministerio	 m i n i s t e r i o 
ministerios	 m i n i s t e r i o s 
ministro	 m i n i s t r o 
minuto	 m i n u t o 
minutos	 m i n u t o s 
miocardio	 m i o k a r d i o 
mio	 m i o 
mirad	 m i r a d 
mira	 m i r a 
miramos	 m i r a m o s 
mirar	 m i r a r 
miras	 m i r a s 
miren	 m i r e n 
miro	 m i r o 
misiones	 m i s i o n e s 
mision	 m i s i o n 
misma	 m i s m a 
mismas	 m i s m a s 
mis	 m i s 
mismo	 m i s m o 
mismos	 m i s m o s 
mitad	 m i t a d 
mit	 m i t 
mix	 m i k s 
mobile	m o b a i l
moda	 m o d a 
model	m o d e l 
modelo	 m o d e l o 
modelos	 m o d e l o s 
moderar	 m o d e r a r 
modesta	 m o d e s t a 
modestia	 m o d e s t i a 
modificado	 m o d i f i k a d o 
modificados	 m o d i f i k a d o s 
modifica	 m o d i f i k a 
modifica	m o d i f i k a b a
modificamos	 m o d i f i k a m o s 
modo	 m o d o 
modos	 m o d o s 
modular	 m o d u l a r 
modulo	 m o d u l o 
modulos	 m o d u l o s 
modus	 m o d u s 
molestan	 m o l e s t a n 
momento	 m o m e n t o 
momentos	 m o m e n t o s 
monitorizados	 m o n i t o r i T a d o s 
monolingüe	 m o n o l i n g u e 
montaña	 m o n t a N a 
montan	 m o n t a n 
montaramos	 m o n t a r a m o s 
montar	 m o n t a r 
monto	 m o n t o 
montones	 m o n t o n e s 
monton	 m o n t o n 
monumentos	 m o n u m e n t o s 
morada	 m o r a d a 
morcilla	 m o r T i y a 
moreno	 m o r e n o 
morfosintactico	 m o r f o s i n t a k t i k o 
mortalidad	 m o r t a l i d a d 
mostraba	 m o s t r a b a 
mostramos	 m o s t r a m o s 
mostrando	 m o s t r a n d o 
mostrarle	 m o s t r a r l e 
mostrarles	 m o s t r a r l e s 
mostrarlo	 m o s t r a r l o 
mostrar	 m o s t r a r 
mostrar	m o s t r a r
motivaciones	 m o t i b a T i o n e s 
motivacion	 m o t i b a T i o n 
motivante	 m o t i b a n t e 
motivar	 m o t i b a r 
motores	 m o t o r e s 
motor	 m o t o r 
mountain	m o u n t a i n
mouse	m a u s
mover	 m o b e r 
movernos	 m o b e r n o s 
moviendo	 m o b i e n d o 
moviles	m o b i l e s
moviles	 m o b i l e s 
movil	m o b i l
movil	 m o b i l 
movimiento	 m o b i m i e n t o 
mucha	 m u C a 
muchas	 m u C a s 
muchisima	 m u C i s i m a 
muchisimas	 m u C i s i m a s 
muchisimo	 m u C i s i m o 
muchisimos	 m u C i s i m o s 
mucho	 m u C o 
muchos	 m u C o s 
muerto	 m u e r t o 
muestral	 m u e s t r a l 
muestra	 m u e s t r a 
muestran	 m u e s t r a n 
muestreo	 m u e s t r e o 
muestro	 m u e s t r o 
muevo	 m u e b o 
multa	 m u l t a 
multilingualidad	 m u l t i l i n g u a l i d a d 
multilingüe	 m u l t i l i n g u e 
multilingües	 m u l t i l i n g u e s 
multilingüismo	 m u l t i l i n g u i s m o 
multimedia	 m u l t i m e d i a 
multimedia	m u l t i m e d i a 
multimodal	 m u l t i m o d a l 
multi	 m u l t i 
multiples	 m u l t i p l e s 
multiplica	 m u l t i p l i k a 
multitud	 m u l t i t u d 
mundial	 m u n d i a l 
mundillo	 m u n d i y o 
mundo	 m u n d o 
mundos	 m u n d o s 
muro	 m u r o 
museo	 m u s e o 
museos	 m u s e o s 
musica	 m u s i k a 
mutua	 m u t u a 
muy	 m u i 
mysql	m s i e T e k u e l e
mystic	m i s t i k
nace	 n a T e 
nacimiento	 n a T i m i e n t o 
nacional	 n a T i o n a l 
nacio	 n a T i o 
nada	 n a d a 
nadie	 n a d i e 
na	e n e a
naive	 n a i f
nativa	 n a t i b a 
nativo	 n a t i b o 
nativos	 n a t i b o s 
naturalmail	n a t u r a l m e i l
naturalmente	 n a t u r a l m e n t e 
naturalmente	n a t u r a l m e n t e
natural	 n a t u r a l 
navegacional	 n a b e g a T i o n a l 
navegacion	 n a b e g a T i o n 
navegador	 n a b e g a d o r 
navegando	 n a b e g a n d o 
navegar	 n a b e g a r 
navegas	 n a b e g a s 
navidades	 n a b i d a d e s 
necesariamente	 n e T e s a r i a m e n t e 
necesaria	 n e T e s a r i a 
necesario	 n e T e s a r i o 
necesidades	 n e T e s i d a d e s 
necesidad	 n e T e s i d a d 
necesitabamos	 n e T e s i t a b a m o s 
necesitaban	 n e T e s i t a b a n 
necesitamos	 n e T e s i t a m o s 
necesita	 n e T e s i t a 
necesitan	 n e T e s i t a n 
necesitariamos	 n e T e s i t a r i a m o s 
necesitas	 n e T e s i t a s 
necesite	 n e T e s i t e 
necesites	 n e T e s i t e s 
necesito	 n e T e s i t o 
negativa	 n e g a t i b a 
negativo	 n e g a t i b o 
negativos	 n e g a t i b o s 
negociaciones	 n e g o T i a T i o n e s 
negociacion	 n e g o T i a T i o n 
negociar	 n e g o T i a r 
negocio	 n e g o T i o 
negocios	 n e g o T i o s 
negrita	 n e g r i t a 
negritas	 n e g r i t a s 
negro	 n e g r o 
negros	 n e g r o s 
neighbour	n e i b u r
net	 n e t 
nevera	 n e b e r a 
nichos	 n i C o s 
nick	 n i k 
nietzsche	 n i C e 
nike	 n a i k 
ninguna	 n i n g u n a 
ningun	n i n g u n
ningun	 n i n g u n 
ninguno	 n i n g u n o 
ni	 n i 
niño	 n i N o 
niños	 n i N o s 
niveles	 n i b e l e s 
nivel	 n i b e l 
nobel	 n o b e l 
noche	 n o C e 
nociones	 n o T i o n e s 
nocion	n o T i o n
nocion	 n o T i o n 
nombradas	 n o m b r a d a s 
nombre	 n o m b r e 
nombres	 n o m b r e s 
nomina	 n o m i n a 
nominas	 n o m i n a s 
no	 n o 
no	n o u
nordicas	 n o r d i k a s 
normalizacion	 n o r m a l i T a T i o n 
normalizar	 n o r m a l i T a r 
normalmente	 n o r m a l m e n t e 
normal	 n o r m a l 
norma	 n o r m a 
norteamericanas	 n o r t e a m e r i k a n a s 
norteamerica	 n o r t e a m e r i k a 
norteamericanos	 n o r t e a m e r i k a n o s 
norte	 n o r t e 
nos	 n o s 
nosotros	 n o s o t r o s 
nostradamus	 n o s t r a d a m u s 
notablemente	 n o t a b l e m e n t e 
nota	 n o t a 
notario	 n o t a r i o 
notar	 n o t a r 
noticia	 n o t i T i a 
noticias	 n o t i T i a s 
not	n o t
novecientas	 n o b e T i e n t a s 
novecientos	 n o b e T i e n t o s 
novedad	 n o b e d a d 
novedosa	 n o b e d o s a 
novela	 n o b e l a 
noventa	 n o b e n t a 
noviembre	 n o b i e m b r e 
ntcs	e n e t e T e s e 
ntsc	e n e t e e s e T e
nubes	 n u b e s 
nuestra	 n u e s t r a 
nuestras	 n u e s t r a s 
nuestro	 n u e s t r o 
nuestros	 n u e s t r o s 
nuevamente	 n u e b a m e n t e 
nuevamente	n u e b a m e n t e
nueva	 n u e b a 
nuevas	 n u e b a s 
nueve	 n u e b e 
nuevo	 n u e b o 
nuevos	 n u e b o s 
numerica	n u m e r i k a
numerica	 n u m e r i k a 
numericas	 n u m e r i k a s 
numerico	n u m e r i k o
numerico	 n u m e r i k o 
numericos	 n u m e r i k o s 
numero	n u m e r o
numero	 n u m e r o 
numeros	n u m e r o s
numeros	 n u m e r o s 
nunca	 n u n k a 
nurenberger	 n u r e n b e r g e r 
objetiva	 o b x e t i b a 
objetivo	 o b x e t i b o 
objetivos	 o b x e t i b o s 
objeto	 o b x e t o 
objetos	 o b x e t o s 
obligan	 o b l i g a n 
obliga	 o b l i g a 
obligas	 o b l i g a s 
obra	 o b r a 
obras	 o b r a s 
observacional	 o b s e r b a T i o n a l 
observamos	 o b s e r b a m o s 
observando	 o b s e r b a n d o 
observa	 o b s e r b a 
observarles	 o b s e r b a r l e s 
observar	 o b s e r b a r 
observatorio	 o b s e r b a t o r i o 
obstante	 o b s t a n t e 
obtenemos	 o b t e n e m o s 
obtenerlo	 o b t e n e r l o 
obtener	 o b t e n e r 
obteniamos	 o b t e n i a m o s 
obtenian	 o b t e n i a n 
obtenia	 o b t e n i a 
obtenias	 o b t e n i a s 
obtenida	 o b t e n i d a 
obtenido	 o b t e n i d o 
obtenidos	 o b t e n i d o s 
obteniendo	 o b t e n i e n d o 
obtienen	 o b t i e n e n 
obtiene	 o b t i e n e 
obtuviera	 o b t u b i e r a 
obtuvimos	 o b t u b i m o s 
obviamente	 o b b i a m e n t e 
obvia	 o b b i a 
obvio	 o b b i o 
ocasiones	 o k a s i o n e s 
ocasion	 o k a s i o n 
occidentales	 o k T i d e n t a l e s 
ochenta	 o C e n t a 
ochocientas	 o C o T i e n t a s 
ochocientas	o C o T i e n t a s
ochocientos	 o C o T i e n t o s 
ocho	 o C o 
ocio	 o T i o 
octubre	 o k t u b r e 
oculta	 o k u l t a 
ocultarle	 o k u l t a r l e 
ocultos	 o k u l t o s 
ocupado	 o k u p a d o 
ocupa	 o k u p a 
ocupara	 o k u p a r a 
ocurren	 o k u R e n 
ocurre	 o k u R e 
ocurrido	 o k u R i d o 
ocurriendo	 o k u R i e n d o 
ocurrio	 o k u R i o 
ocurrir	 o k u R i r 
ofertando	 o f e r t a n d o 
oferta	 o f e r t a 
ofertas	 o f e r t a s 
offline	o f l a i n
oficiales	 o f i T i a l e s 
oficina	 o f i T i n a 
oficina	o f i T i n a
of	o f
ofrecemos	 o f r e T e m o s 
ofrecen	 o f r e T e n 
ofrece	 o f r e T e 
ofrecer	 o f r e T e r 
ofreciera	 o f r e T i e r a 
ofreciese	 o f r e T i e s e 
ofrecio	 o f r e T i o 
oido	 o i d o 
oiga	 o + i g a 
oimos	o i m o s
oimos	 o i m o s 
ok	 O u k e i
olimpiadas	 o l i m p i a d a s 
olvidaba	 o l b i d a b a 
olvidado	 o l b i d a d o 
olvidar	 o l b i d a r 
once	o n c e
once	 o n T e 
once	u a n s
ong	o e n e x e
online	o n l a i n
on-line / online	 o n l a i n
ontiveros	 o n t i b e r o s 
ontologia	 o n t o l o x i a 
ontologias	 o n t o l o x i a s 
o	 o 
o	o 
opa	 o p a 
opciones	 o p T i o n e s 
opcion	 o p T i o n 
open	o u p e n
opentrad	 o p e n t r a d 
operaciones	 o p e r a T i o n e s 
operadores	 o p e r a d o r e s 
operador	 o p e r a d o r 
operandi	 o p e r a n d i 
operar	 o p e r a r 
operativo	 o p e r a t i b o 
opinan	 o p i n a n 
opinion	 o p i n i o n 
oportunas	 o p o r t u n a s 
oportunidades	 o p o r t u n i d a d e s 
oportunidad	 o p o r t u n i d a d 
optica	 o p t i k a 
optima	 o p t i m a 
optimo	 o p t i m o 
oraculo	 o r a k u l o 
ordenacion	 o r d e n a T i o n 
ordenado	 o r d e n a d o 
ordenadores	 o r d e n a d o r e s 
ordenador	 o r d e n a d o r 
ordenados	 o r d e n a d o s 
ordenar	 o r d e n a r 
ordenes	 o r d e n e s 
orden	 o r d e n 
organismo	 o r g a n i s m o 
organismos	 o r g a n i s m o s 
organizaciones	 o r g a n i T a T i o n e s 
organizacion	 o r g a n i T a T i o n 
organizado	 o r g a n i T a d o 
organizadores	 o r g a n i T a d o r e s 
organizar	 o r g a n i T a r 
organizo	o r g a n i T o
organizo	 o r g a n i T o 
org	 or 
orgullosisimos	 o r g u y o s i s i m o s 
orientacion	 o r i e n t a T i o n 
orientadas	 o r i e n t a d a s 
orientado	 o r i e n t a d o 
orientados	 o r i e n t a d o s 
orientandose	 o r i e n t a n d o s e 
origen	 o r i x e n 
originalmente	 o r i x i n a l m e n t e 
original	 o r i x i n a l 
originurlextension	o r i y i n u e R e e l e e k s t e n s i o n
oro	 o r o 
ortografica	 o r t o g r a f i k a 
ortografico	 o r t o g r a f i k o 
ortograficos	 o r t o g r a f i k o s 
oscila	 o s T i l a 
os	 o s 
otaedor	o t a e d o r
oteador	 o t e a d o r 
otorgaban	 o t o r g a b a n 
otorgadas	 o t o r g a d a s 
otorgado	 o t o r g a d o 
otorgados	 o t o r g a d o s 
otorgan	 o t o r g a n 
otorga	 o t o r g a 
otorgar	 o t o r g a r 
otra	 o t r a 
otras	 o t r a s 
otro	 o t r o 
otros	 o t r o s 
ottovonguericke	o t o b o n g e r i k
outsourcing	a u t s o u r s i n g
oxford	 o k s f o r 
oyendo	 o y e n d o 
oye	 o y e 
pablo	 p a b l o 
paciente	 p a T i e n t e 
pacientes	 p a T i e n t e s 
pacifico	 p a T i f i k o 
padre	 p a d r e 
pagado	 p a g a d o 
pagados	 p a g a d o s 
pagamos	 p a g a m o s 
pagando	 p a g a n d o 
pagan	 p a g a n 
pagarlos	 p a g a r l o s 
pagar	 p a g a r 
page	p e i y
pagerank	p e i y r a n k
pagina	p a x i n a	
pagina	 p a x i n a 
paginas	 p a x i n a s 
pago	p a g o
pagos	 p a g o s 
painting	p e i n t i n g
paises	 p a i s e s 
pais	 p a i s 
pajaro	p a x a r o
pajaro	 p a x a r o 
pajas	 p a x a s 
palabra	 p a l a b r a 
palabras	 p a l a b r a s 
palmario	 p a l m a r i o 
paloma	 p a l o m a 
pal	p a l
pana	 p a n a 
paneles	 p a n e l e s 
panelistas	 p a n e l i s t a s 
panhispanico	 p a n i s p a n i k o 
pantalla	 p a n t a y a 
papa	p a p a
papa	 p a p a 
papeleria	 p a p e l e r i a 
papeles	 p a p e l e s 
papel	 p a p e l 
paquete	 p a k e t e 
parada	 p a r a d a 
parada	p a r a d a
paralelo	 p a r a l e l o 
parametro	 p a r a m e t r o 
parametros	 p a r a m e t r o s 
para	 p a r a 
parar	 p a r a r 
parches	 p a r C e s 
parcialmente	 p a r T i a l m e n t e 
parecen	 p a r e T e n 
parecen	p a r e T e n
parece	 p a r e T e 
pareceria	 p a r e T e r i a 
parecer	 p a r e T e r 
parecia	 p a r e T i a 
parecida	 p a r e T i d a 
parecidas	 p a r e T i d a s 
parecido	 p a r e T i d o 
parecidos	 p a r e T i d o s 
parecieron	 p a r e T i e r o n 
parecio	 p a r e T i o 
pareja	 p a r e x a 
pares	 p a r e s 
parezca	 p a r e T k a 
paris	p a r i s
paris	 p a r i s 
park	p a r k
parlamento	 p a r l a m e n t o 
parlamentos	 p a r l a m e n t o s 
par	 p a r 
parque	 p a r k e 
parte	 p a r t e 
partes	 p a r t e s 
participaban	 p a r t i T i p a b a n 
participaba	 p a r t i T i p a b a 
participacion	 p a r t i T i p a T i o n 
participado	 p a r t i T i p a d o 
participamos	 p a r t i T i p a m o s 
participando	 p a r t i T i p a n d o 
participan	 p a r t i T i p a n 
participante	 p a r t i T i p a n t e 
participantes	 p a r t i T i p a n t e s 
participa	 p a r t i T i p a 
participaron	 p a r t i T i p a r o n 
participar	 p a r t i T i p a r 
particulares	 p a r t i k u l a r e s 
particular	 p a r t i k u l a r 
partida	 p a r t i d a 
partidario	 p a r t i d a r i o 
partido	 p a r t i d o 
partiendo	 p a r t i e n d o 
partimos	 p a r t i m o s 
partipantes	 p a r t i p a n t e s 
partir	 p a r t i r 
pasaba	 p a s a b a 
pasada	 p a s a d a 
pasado	 p a s a d o 
pasamos	 p a s a m o s 
pasando	 p a s a n d o 
pasando	p a s a n d o
pasan	 p a s a n 
pasa	 p a s a 
pasa	p a s a
pasaporte	 p a s a p o r t e 
pasara	 p a s a r a 
pasare	 p a s a r e 
pasaria	 p a s a r i a 
pasarlo	 p a s a r l o 
pasarlo	p a s a r l o
pasaron	 p a s a r o n 
pasar	 p a s a r 
pasas	 p a s a s 
paseas	 p a s e a s 
pasemos	 p a s e m o s 
pase	 p a s e 
pases	 p a s e s 
pasiva	 p a s i b a 
pasivo	 p a s i b o 
pasivos	 p a s i b o s 
paso	 p a s o 
paso	 p a s o 
pasos	 p a s o s 
patagonia	 p a t a g o n i a 
pata	 p a t a 
patches	p a C e s
patente	 p a t e n t e 
patentes	 p a t e n t e s 
patrimonio	 p a t r i m o n i o 
patrocinadoras	 p a t r o T i n a d o r a s 
patrocinio	 p a t r o T i n i o 
patrocinios	 p a t r o T i n i o s 
patrones	 p a t r o n e s 
patron	 p a t r o n 
pattern	p a t e r n
paulatinamente	 p a u l a t i n a m e n t e 
paul	 p o l 
pauperrimo	 p a u p e R i m o 
paz	 p a T 
pdf	p e d e e f e
pdfs	p e d e e f e s
peculiaridad	 p e k u l i a r i d a d 
pederastia	 p e d e r a s t i a 
pedian	 p e d i a n 
pedia	 p e d i a 
pedidito	 p e d i d i t o 
pedido	 p e d i d o 
pedimos	 p e d i m o s 
pedira	 p e d i r a 
pediria	 p e d i r i a 
pedirme	 p e d i r m e 
pedir	 p e d i r 
peer	p e e r
pegamos	 p e g a m o s 
pegan	 p e g a n 
pegar	 p e g a r 
pelados	 p e l a d o s 
pelearais	 p e l e a r a i s 
peliagudo	 p e l i a g u d o 
peligroso	 p e l i g r o s o 
pena	 p e n a 
penas	 p e n a s 
peñas	 p e N a s 
penetracion	 p e n e t r a T i o n 
peninsula	 p e n i n s u l a 
penosa	 p e n o s a 
pensabamos	 p e n s a b a m o s 
pensaban	 p e n s a b a n 
pensadlo	 p e n s a d l o 
pensado	 p e n s a d o 
pensad	p e n s a d
pensais	 p e n s a i s 
pensamos	 p e n s a m o s 
pensando	 p e n s a n d o 
pensar	 p e n s a r 
pensarselo	 p e n s a r s e l o 
pense	p e n s e
pense	 p e n s e 
pensiones	 p e n s i o n e s 
penso	 p e n s o 
penultimo	 p e n u l t i m o 
peor	 p e o r 
pepinazo	 p e p i n a T o 
pepsi	 p e p s i 
pequeña	 p e k e N a 
pequeñas	 p e k e N a s 
pequeñita	 p e k e N i t a 
pequeño	 p e k e N o 
pequeños	 p e k e N o s 
percepcion	 p e r T e p T i o n 
perder	 p e r d e r 
perdia	p e r d i a 
perdia	 p e r d i a 
perdido	 p e r d i d o 
perdiendo	 p e r d i e n d o 
perdonad	 p e r d o n a d 
perdon	p e r d o n
perdon	 p e r d o n 
perecer	 p e r e T e r 
perfeccionando	 p e r f e k T i o n a n d o 
perfectamente	 p e r f e k t a m e n t e 
perfecta	 p e r f e k t a 
perfectas	 p e r f e k t a s 
perfecto	 p e r f e k t o 
perfectos	 p e r f e k t o s 
perfiladas	 p e r f i l a d a s 
perfilado	 p e r f i l a d o 
perfilamos	 p e r f i l a m o s 
perfilar	 p e r f i l a r 
perfiles	 p e r f i l e s 
perfil	 p e r f i l 
performance	 p e r f o r m e n s
periodicamente	 p e r i o d i k a m e n t e 
periodismo	 p e r i o d i s m o 
periodista	 p e r i o d i s t a 
periodista	p e r i o d i s t a	
periodo	 p e r i o d o 
periodo	 p e r i o d o 
periodos	 p e r i o d o s 
perl	 p e r l 
permisos	 p e r m i s o s 
permitanme	 p e r m i t a n m e 
permitan	 p e r m i t a n 
permita	 p e r m i t a 
permiten	 p e r m i t e n 
permiten	p e r m i t e n
permite	 p e r m i t e 
permitia	 p e r m i t i a 
permitidas	 p e r m i t i d a s 
permitido	 p e r m i t i d o 
permitidos	 p e r m i t i d o s 
permitiera	 p e r m i t i e r a 
permitir	 p e r m i t i r 
perniciosos	 p e r n i T i o s o s 
perogrullada	 p e r o g r u y a d a 
pero	 p e r o 
per	 p e r 
perro	 p e R o 
perseverancia	 p e r s e b e r a n T i a 
persiana	 p e r s i a n a 
persigue	 p e r s i g e 
personaje	 p e r s o n a x e 
personajes	 p e r s o n a x e s 
personales	 p e r s o n a l e s 
personalidad	 p e r s o n a l i d a d 
personalizacion	p e r s o n a l i T a T i o n
personalizacion	 p e r s o n a l i T a T i o n 
personalizada	 p e r s o n a l i T a d a 
personalmente	 p e r s o n a l m e n t e 
personal	 p e r s o n a l 
persona	 p e r s o n a 
persona	p e r s o n a
personas	 p e r s o n a s 
perspectiva	 p e r s p e k t i b a 
perspectiva	p e r s p e k t i b a
perspectivas	 p e r s p e k t i b a s 
pertenece	 p e r t e n e T e 
pertenecer	 p e r t e n e T e r 
perteneciente	 p e r t e n e T i e n t e 
pertenencia	 p e r t e n e n T i a 
pertinente	 p e r t i n e n t e 
pertinentes	 p e r t i n e n t e s 
peru	 p e r u 
pesada	 p e s a d a 
pesar	 p e s a r 
peseta	 p e s e t a 
peso	 p e s o 
pesos	 p e s o s 
peticiones	 p e t i T i o n e s 
peticion	 p e t i T i o n 
photo	f o t o
php	p e a C e p e
pib	p e i b
picaban	 p i k a b a n 
picasso	 p i k a s o 
pico	 p i k o 
pida	 p i d a 
piden	 p i d e n 
pide	 p i d e 
pides	 p i d e s 
pidiendo	 p i d i e n d o 
pido	 p i d o 
piedra	 p i e d r a 
piensan	 p i e n s a n 
piensa	 p i e n s a 
piensen	 p i e n s e n 
piense	 p i e n s e 
pienso	 p i e n s o 
pierdas	 p i e r d a s 
pierde	 p i e r d e 
pierdes	 p i e r d e s 
pieza	 p i e T a 
piezas	 p i e T a s 
pilas	 p i l a s 
pillado	 p i y a d o 
piloto	 p i l o t o 
pilotos	 p i l o t o s 
pinchabas	 p i n C a b a s 
pinchando	 p i n C a n d o 
pincha	 p i n C a 
pinchar	 p i n C a r 
pinche	 p i n C e 
pintado	 p i n t a d o 
pinto	 p i n t o 
pintura	 p i n t u r a 
pinturas	 p i n t u r a s 
pionero	 p i o n e r o 
pique	 p i k e 
piratea	 p i r a t e a 
piratear	 p i r a t e a r 
piscina	 p i s T i n a 
pista	 p i s t a 
pistas	 p i s t a s 
pixel	p i k s e l
pixel	 p i k s e l 
planes	 p l a n e s 
planificar	 p l a n i f i k a r 
plano	 p l a n o 
plano	p l a n o
plan	 p l a n 
plantaramos	 p l a n t a r a m o s 
plantas	 p l a n t a s 
planteabamos	 p l a n t e a b a m o s 
planteaba	 p l a n t e a b a 
planteado	 p l a n t e a d o 
planteamiento	 p l a n t e a m i e n t o 
planteamos	 p l a n t e a m o s 
planteando	 p l a n t e a n d o 
planteandose	 p l a n t e a n d o s e 
plantean	 p l a n t e a n 
plantea	 p l a n t e a 
plantearon	 p l a n t e a r o n 
plantear	 p l a n t e a r 
plantearse	 p l a n t e a r s e 
planteas	 p l a n t e a s 
planteo	 p l a n t e o 
plantilla	 p l a n t i y a 
plasmarlas	 p l a s m a r l a s 
plastificado	 p l a s t i f i k a d o 
plataforma	 p l a t a f o r m a 
playa	 p l a y a 
playa	p l a y a
player	p l e y e r
play	 p l e i 
plaza	 p l a T a 
plazo	 p l a T o 
plena	 p l e n a 
plm	p e e l e e m e
plural	 p l u r a l 
pluriño	 p l u r i N o 
plusvalia	 p l u s b a l i a 
pnl	p e e n e e l e
poblacionales	 p o b l a T i o n a l e s 
poblacion	p o b l a T i o n
poblacion	 p o b l a T i o n 
poca	 p o k a 
pocas	 p o k a s 
poco	 p o k o 
pocos	 p o k o s 
podamos	 p o d a m o s 
podeis	 p o d e i s 
podeis	 p o d e i s 
podemos	 p o d e m o s 
poderle	 p o d e r l e 
poderle	p o d e r l e
poder	 p o d e r 
podiamos	 p o d i a m o s 
podian	 p o d i a n 
podia	 p o d i a 
podias	 p o d i a s 
podido	 p o d i d o 
podran	 p o d r a n 
podra	 p o d r a 
podremos	 p o d r e m o s 
podriamos	p o d r i a m o s
podriamos	 p o d r i a m o s 
podrian	 p o d r i a n 
podria	p o d r i a
podria	 p o d r i a 
police	p o l i s
politecnica	p o l i t e k n i k a
politecnica	 p o l i t e k n i k a 
politica	 p o l i t i k a 
politicas	 p o l i t i k a s 
politico	 p o l i t i k o 
politicos	 p o l i t i k o s 
ponderacion	 p o n d e r a T i o n 
ponderar	 p o n d e r a r 
pondran	 p o n d r a n 
pondremos	 p o n d r e m o s 
poneis	 p o n e i s 
ponemos	 p o n e m o s 
ponen	 p o n e n 
ponen	p o n e n
ponentes	 p o n e n t e s 
pone	 p o n e 
ponerle	 p o n e r l e 
ponerlo	 p o n e r l o 
ponerlos	 p o n e r l o s 
ponernos	 p o n e r n o s 
poneros	 p o n e r o s 
poner	 p o n e r 
ponerse	 p o n e r s e 
pones	 p o n e s 
pongalo	 p o n g a l o 
pongalos	 p o n g a l o s 
pongamos	 p o n g a m o s 
pongan	 p o n g a n 
ponga	 p o n g a 
pongas	 p o n g a s 
pongo	 p o n g o 
ponian	 p o n i a n 
ponia	 p o n i a 
poniendo	 p o n i e n d o 
pon	 p o n 
ponte	 p o n t e 
pop	 p o p 
populares	 p o p u l a r e s 
popularidad	 p o p u l a r i d a d 
poquitas	 p o k i t a s 
poquitin	 p o k i t i n 
poquito	 p o k i t o 
poquitos	 p o k i t o s 
porcentaje	 p o r T e n t a x e 
porcentajes	 p o r T e n t a x e s 
pornografia	 p o r n o g r a f i a 
pornograficas	 p o r n o g r a f i k a s 
por	 p o r 
por	p o r
porque	 p o r k e 
porque	 p o r k e 
porrada	 p o R a d a 
portada	 p o r t a d a 
portales	 p o r t a l e s 
portal	 p o r t a l 
porter	 p o r t e r 
portugal	 p o r t u g a l 
portugueses	 p o r t u g e s e s 
portugues	 p o r t u g e s 
posgrado	 p o s g r a d o 
posibilidades	 p o s i b i l i d a d e s 
posibilidad	 p o s i b i l i d a d 
posiblemente	 p o s i b l e m e n t e 
posible	 p o s i b l e 
posibles	 p o s i b l e s 
posicionamiento	 p o s i T i o n a m i e n t o 
posicionar	 p o s i T i o n a r 
posicionarse	 p o s i T i o n a r s e 
posiciones	 p o s i T i o n e s 
posicion	p o s i T i o n
posicion	 p o s i T i o n 
position	 p o s i s i o n 
positiva	 p o s i t i b a 
positivo	 p o s i t i b o 
positivos	 p o s i t i b o s 
poso	 p o s o 
postcript	p o s t s k r i p t
posteriori	 p o s t e r i o r i 
posteriormente	 p o s t e r i o r m e n t e 
posterior	 p o s t e r i o r 
postgrado	 p o s g r a d o 
postlicenciatura	 p o s l i T e n T i a t u r a 
post	 p o u s t 
postproceso	 p o s p r o T e s o 
postscript	p o s t s k r i p t s
posts	p o s t s
potenciales	 p o t e n T i a l e s 
potencial	 p o t e n T i a l 
potencia	 p o t e n T i a 
potenciar	 p o t e n T i a r 
potente	 p o t e n t e 
potentes	 p o t e n t e s 
potter	 p o t e 
powerpoint	 p a g u e r p o i n t 
poyada	 p o y a d a 
practicamente	 p r a k t i k a m e n t e 
practican	 p r a k t i k a n 
practica	 p r a k t i k a 
practicas	 p r a k t i k a s 
practico	 p r a k t i k o 
precatalogada	 p r e k a t a l o g a d a 
precaucion	 p r e k a u T i o n 
precio	 p r e T i o 
preciosa	 p r e T i o s a 
precioso	 p r e T i o s o 
precios	 p r e T i o s 
precipitadamente	 p r e T i p i t a d a m e n t e 
precisamente	 p r e T i s a m e n t e 
precisa	 p r e T i s a 
precision	 p r e T i s i o n 
precision	 p r e T i s i o n 
predicen	 p r e d i T e n 
prediciendo	 p r e d i T i e n d o 
predilecto	 p r e d i l e k t o 
predominante	 p r e d o m i n a n t e 
preeminente	 p r e e m i n e n t e 
preferiblemente	 p r e f e r i b l e m e n t e 
preferido	 p r e f e r i d o 
prefiere	 p r e f i e r e 
prefiero	 p r e f i e r o 
prefijada	 p r e f i x a d a 
preguntaban	 p r e g u n t a b a n 
preguntabas	 p r e g u n t a b a s 
preguntamos	 p r e g u n t a m o s 
preguntando	 p r e g u n t a n d o 
preguntan	 p r e g u n t a n 
pregunta	 p r e g u n t a 
preguntaros	 p r e g u n t a r o s 
preguntar	 p r e g u n t a r 
preguntas	 p r e g u n t a s 
pregunto	 p r e g u n t o 
pregunto	 p r e g u n t o 
preinscripcion	 p r e i n s k r i p T i o n 
premio	 p r e m i o 
premios	 p r e m i o s 
prensa	 p r e n s a 
preocupacion	 p r e o k u p a T i o n 
preocupado	 p r e o k u p a d o 
preocupamos	 p r e o k u p a m o s 
preocupan	 p r e o k u p a n 
preocupante	 p r e o k u p a n t e 
preocupa	 p r e o k u p a 
preocupar	 p r e o k u p a r 
preparado	 p r e p a r a d o 
preparados	 p r e p a r a d o s 
preparamos	 p r e p a r a m o s 
preparando	 p r e p a r a n d o 
prepara	 p r e p a r a 
preparar	 p r e p a r a r 
preponderante	 p r e p o n d e r a n t e 
preseleccionados	 p r e s e l e k T i o n a d o s 
presencia	 p r e s e n T i a 
presencias	 p r e s e n T i a s 
presentaban	 p r e s e n t a b a n 
presentaba	 p r e s e n t a b a 
presentaciones	 p r e s e n t a T i o n e s 
presentacion	p r e s e n t a T i o n
presentacion	 p r e s e n t a T i o n 
presentado	 p r e s e n t a d o 
presentados	 p r e s e n t a d o s 
presentamos	 p r e s e n t a m o s 
presentandolo	 p r e s e n t a n d o l o 
presentando	 p r e s e n t a n d o 
presentandose	 p r e s e n t a n d o s e 
presentan	 p r e s e n t a n 
presenta	 p r e s e n t a 
presentaremos	 p r e s e n t a r e m o s 
presentarle	 p r e s e n t a r l e 
presentarles	 p r e s e n t a r l e s 
presentar	 p r e s e n t a r 
presentar	p r e s e n t a r
presenteis	 p r e s e n t e i s 
presenten	 p r e s e n t e n 
presente	 p r e s e n t e 
presente	 p r e s e n t e 
presentes	 p r e s e n t e s 
presento	 p r e s e n t o 
presento	 p r e s e n t o 
presidencia	 p r e s i d e n T i a 
presidente	 p r e s i d e n t e 
prestaron	 p r e s t a r o n 
prestigio	 p r e s t i x i o 
prestigiosas	 p r e s t i x i o s a s 
presupuesto	 p r e s u p u e s t o 
presupuestos	 p r e s u p u e s t o s 
pretendemos	 p r e t e n d e m o s 
pretenden	 p r e t e n d e n 
pretendia	 p r e t e n d i a 
pretendo	 p r e t e n d o 
pretratamiento	 p r e t r a t a m i e n t o 
previamente	 p r e b i a m e n t e 
previa	 p r e b i a 
previo	 p r e b i o 
previos	 p r e b i o s 
previsible	 p r e b i s i b l e 
previsiones	 p r e b i s i o n e s 
previstas	 p r e b i s t a s 
previsto	 p r e b i s t o 
primavera	 p r i m a b e r a 
primera	 p r i m e r a 
primeras	 p r i m e r a s 
primero	 p r i m e r o 
primeros	 p r i m e r o s 
primer	 p r i m e r 
primer	p r i m e r
primo	 p r i m o 
principales	 p r i n T i p a l e s 
principalmente	 p r i n T i p a l m e n t e 
principal	 p r i n T i p a l 
principio	 p r i n T i p i o 
principios	 p r i n T i p i o s 
prioridad	 p r i o r i d a d 
priori	 p r i o r i 
prioritaria	 p r i o r i t a r i a 
priorizar	 p r i o r i T a r 
privada	 p r i b a d a 
privadas	 p r i b a d a s 
privado	 p r i b a d o 
privatizado	 p r i b a t i T a d o 
privilegiadas	 p r i b i l e x i a d a s 
privilegiado	 p r i b i l e x i a d o 
probabilidad	 p r o b a b i l i d a d 
probabilista	 p r o b a b i l i s t a 
probablemente	 p r o b a b l e m e n t e 
probable	 p r o b a b l e 
probador	 p r o b a d o r 
probamos	 p r o b a m o s 
probarlo	 p r o b a r l o 
probar	 p r o b a r 
probe	 p r o b e 
problema	 p r o b l e m a 
problemas	 p r o b l e m a s 
problematica	 p r o b l e m a t i k a 
probo	p r o b o
probo	 p r o b o 
procedimientos	 p r o T e d i m i e n t o s 
procesador	 p r o T e s a d o r 
procesamiento	 p r o T e s a m i e n t o 
procesamientos	 p r o T e s a m i e n t o s 
procesaran	 p r o T e s a r a n 
procesar	 p r o T e s a r 
proceso	 p r o T e s o 
proceso	p r o T e s o	
procesos	 p r o T e s o s 
processing	p r o T e s i n g
procurado	 p r o k u r a d o 
procuren	 p r o k u r e n 
produccion	 p r o d u k T i o n 
producen	 p r o d u T e n 
produce	 p r o d u T e 
producido	 p r o d u T i d o 
produciendo	 p r o d u T i e n d o 
producimos	 p r o d u T i m o s 
producirlo	 p r o d u T i r l o 
producir	 p r o d u T i r 
producto	 p r o d u k t o 
productores	 p r o d u k t o r e s 
productos	 p r o d u k t o s 
produjo	 p r o d u x o 
produzcan	 p r o d u T k a n 
profesionales	 p r o f e s i o n a l e s 
profesional	 p r o f e s i o n a l 
profesion	 p r o f e s i o n 
profesoras	 p r o f e s o r a s 
profesores	 p r o f e s o r e s 
profesor	 p r o f e s o r 
profeta	 p r o f e t a 
profit	 p r o f i t 
profunda	 p r o f u n d a 
profundas	 p r o f u n d a s 
profundidad	 p r o f u n d i d a d 
profundizando	 p r o f u n d i T a n d o 
profundizar	 p r o f u n d i T a r 
programaciones	 p r o g r a m a T i o n e s 
programacion	p r o g r a m a T i o n
programacion	 p r o g r a m a T i o n 
programado	 p r o g r a m a d o 
programadores	 p r o g r a m a d o r e s 
programa	 p r o g r a m a 
programar	 p r o g r a m a r 
programas	 p r o g r a m a s 
prohibido	 p r o i b i d o 
prolongadas	 p r o l o n g a d a s 
promedio	 p r o m e d i o 
prometedores	 p r o m e t e d o r e s 
prometian	p r o m e t i a n
prometian	 p r o m e t i a n 
prometido	 p r o m e t i d o 
promocionamos	 p r o m o T i o n a m o s 
promocionen	 p r o m o T i o n e n 
promocion	 p r o m o T i o n 
promovamoslo	 p r o m o b a m o s l o 
promover	 p r o m o b e r 
pronuncia	 p r o n u n T i a 
propiamente	 p r o p i a m e n t e 
propia	 p r o p i a 
propias	 p r o p i a s 
propiedades	 p r o p i e d a d e s 
propiedad	 p r o p i e d a d 
propietario	 p r o p i e t a r i o 
propio	 p r o p i o 
propios	 p r o p i o s 
propondre	 p r o p o n d r e 
proponemos	 p r o p o n e m o s 
proponemos	p r o p o n e m o s
proponen	 p r o p o n e n 
propone	 p r o p o n e 
proponer	 p r o p o n e r 
propongais	 p r o p o n g a i s 
propongo	 p r o p o n g o 
proponiamos	 p r o p o n i a m o s 
proponian	 p r o p o n i a n 
proponia	 p r o p o n i a 
proponiendo	 p r o p o n i e n d o 
proporcionalmente	 p r o p o r T i o n a l m e n t e 
proporcional	 p r o p o r T i o n a l 
proporcionamos	 p r o p o r T i o n a m o s 
proporcionando	 p r o p o r T i o n a n d o 
proporcionan	 p r o p o r T i o n a n 
proporciona	 p r o p o r T i o n a 
proporcionar	 p r o p o r T i o n a r 
proporcion	p r o p o r T i o n
proporcion	 p r o p o r T i o n 
proposicion	p r o p o s i T i o n
proposicion	 p r o p o s i T i o n 
proposito	 p r o p o s i t o 
pro	 p r o 
propuesta	 p r o p u e s t a 
propuestas	 p r o p u e s t a s 
propuesto	 p r o p u e s t o 
propusimos	 p r o p u s i m o s 
propuso	 p r o p u s o 
protagonismo	 p r o t a g o n i s m o 
proteccion	 p r o t e k T i o n 
protege	 p r o t e x e 
protegerlo	 p r o t e x e r l o 
proteger	 p r o t e x e r 
protegidos	 p r o t e x i d o s 
prototipo	 p r o t o t i p o 
prototipos	 p r o t o t i p o s 
provecho	 p r o b e C o 
proveedores	 p r o b e e d o r e s 
proveedor	 p r o b e e d o r 
provienen	 p r o b i e n e n 
proviene	 p r o b i e n e 
provincia	 p r o b i n T i a 
provino	 p r o b i n o 
proximo	 p r o k s i m o 
proximos	p r o k s i m o s
proximos	 p r o k s i m o s 
proyecto	 p r o y e k t o 
proyectos	 p r o y e k t o s 
prueba	 p r u e b a 
pruebas	 p r u e b a s 
psicologico	 s i k o l o x i k o 
psicologos	 s i k o l o g o s 
publicaciones	 p u b l i k a T i o n e s 
publicacion	 p u b l i k a T i o n 
publicada	 p u b l i k a d a 
publicado	 p u b l i k a d o 
publicamente	 p u b l i k a m e n t e 
publicamos	 p u b l i k a m o s 
publicando	 p u b l i k a n d o 
publican	 p u b l i k a n 
publica	 p u b l i k a 
publica	 p u b l i k a 
publicaran	 p u b l i k a r a n 
publicar	 p u b l i k a r 
publicas	 p u b l i k a s 
publicidad	 p u b l i T i d a d 
publicista	 p u b l i T i s t a 
publicistas	 p u b l i T i s t a s 
publicitaria	 p u b l i T i t a r i a 
publicitario	 p u b l i T i t a r i o 
publico	 p u b l i k o 
publicos	 p u b l i k o s 
publiquen	 p u b l i k e n 
publique	 p u b l i k e 
pude	 p u d e 
pudieramos	 p u d i e r a m o s 
pudieran	 p u d i e r a n 
pudiera	 p u d i e r a 
pudimos	 p u d i m o s 
pudo	 p u d o 
pueblo	 p u e b l o 
puedan	 p u e d a n 
pueda	 p u e d a 
puedas	 p u e d a s 
pueden	 p u e d e n 
pueden	p u e d e n
puede	 p u e d e 
puedes	 p u e d e s 
puedo	 p u e d o 
puerta	 p u e r t a 
pues	 p u e s 
puesta	 p u e s t a 
puestas	 p u e s t a s 
puesto	 p u e s t o 
puf	 p u f 
pulmon	 p u l m o n 
punto	 p u n t o 
puntos	 p u n t o s 
puntuacion	 p u n t u a T i o n 
puntuales	 p u n t u a l e s 
puntual	 p u n t u a l 
puramente	 p u r a m e n t e 
pura	 p u r a 
puras	 p u r a s 
puro	 p u r o 
puse	 p u s e 
pusieramos	 p u s i e r a m o s 
pusimos	 p u s i m o s 
puso	 p u s o 
pyme	 p i m e 
quebrabamos	 k e b r a b a m o s 
quebrar	 k e b r a r 
quedaba	 k e d a b a 
quedabamos	 k e d a b a m o s 
quedaban	 k e d a b a n 
quedado	 k e d a d o 
queda	 k e d a 
quedamos	 k e d a m o s 
quedan	 k e d a n 
quedar	 k e d a r 
quedarme	 k e d a r m e 
quedarnos	 k e d a r n o s 
quedaron	 k e d a r o n 
quedarse	 k e d a r s e 
quedate	 k e d a t e 
quede	 k e d e 
queden	 k e d e n 
quedo	 k e d o 
quedo	 k e d o 
que	 k e 
que	k e
que	 k e 
querais	 k e r a i s 
queramos	 k e r a m o s 
quereis	 k e r e i s 
queremos	 k e r e m o s 
querer	 k e r e r 
queresmos	 k e r e s m o s 
queriais	 k e r i a i s 
queria	k e r i a
queria	 k e r i a 
queriamos	k e r i a m o s
queriamos	 k e r i a m o s 
querian	k e r i a n
querian	 k e r i a n 
querias	 k e r i a s 
querido	 k e r i d o 
querria	 k e R i a 
query	k u e r i
questionanswering	k u e s t i o n a n s u e r i n g
question	k u e s t i o n
quevedo	 k e b e d o 
quienes	 k i e n e s 
quien	 k i e n 
quien	 k i e n 
quiera	 k i e r a 
quieran	 k i e r a n 
quieras	 k i e r a s 
quiere	 k i e r e 
quieren	 k i e r e n 
quieres	 k i e r e s 
quiero	 k i e r o 
quince	 k i n T e 
quinientas	 k i n i e n t a s 
quinientos	 k i n i e n t o s 
quinto	 k i n t o 
quirofanos	 k i r o f a n o s 
quirurgicas	 k i r u r x i k a s 
quisiera	 k i s i e r a 
quisieramos	 k i s i e r a m o s 
quisieras	 k i s i e r a s 
quisimos	 k i s i m o s 
quitamos	 k i t a m o s 
quitando	 k i t a n d o 
quitaran	 k i t a r a n 
quitarnos	 k i t a r n o s 
quitasemos	 k i t a s e m o s 
quiza	 k i T a 
quizas	 k i T a s 
radicalmente	 R a d i k a l m e n t e 
radiografia	 R a d i o g r a f i a 
radiografias	 R a d i o g r a f i a s 
radio	 R a d i o 
radique	 R a d i k e 
raiz	 R a i T 
ralentizado	 R a l e n t i T a d o 
rango	 R a n g o 
rangos	 R a n g o s 
ranking	 R a n k i n 
rankings	 R a n k i n s 
rapidamente	R a p i d a m e n t e
rapidamente	 R a p i d a m e n t e 
rapida	R a p i d a
rapida	 R a p i d a 
rapido	R a p i d o
rapido	 R a p i d o 
rapidos	 R a p i d o s 
raramente	 R a r a m e n t e 
rara	 R a r a 
raras	 R a r a s 
raro	 R a r o 
rastreabilidad	 R a s t r e a b i l i d a d 
rastreable	 R a s t r e a b l e 
rastreables	 R a s t r e a b l e s 
rastreada	 R a s t r e a d a 
rastrear	 R a s t r e a r 
ratio	 R a t i o 
ratios	 R a t i o s 
raton	 R a t o n 
rato	 R a t o 
razonablemente	 R a T o n a b l e m e n t e 
razonable	 R a T o n a b l e 
razonables	 R a T o n a b l e s 
razonamiento	 R a T o n a m i e n t o 
razones	 R a T o n e s 
razon	R a T o n
razon	 R a T o n 
reales	 R e a l e s 
realidad	 R e a l i d a d 
realimentacion	 R e a l i m e n t a T i o n 
realista	 R e a l i s t a 
realistas	 R e a l i s t a s 
realizado	 R e a l i T a d o 
realizados	 R e a l i T a d o s 
realizamos	 R e a l i T a m o s 
realizando	 R e a l i T a n d o 
realizan	 R e a l i T a n 
realiza	 R e a l i T a 
realizare	 R e a l i T a r e 
realizar	 R e a l i T a r 
realmente	 R e a l m e n t e 
real	 R e a l 
rebajar	 R e b a x a r 
rebajas	 R e b a x a s 
rebatido	 R e b a t i d o 
recado	 R e k a d o 
recados	 R e k a d o s 
recall	R e k o l
recapitulacion	 R e k a p i t u l a T i o n 
receptiva	 R e T e p t i b a 
receta	 R e T e t a 
recetaros	 R e T e t a r o s 
recetar	 R e T e t a r 
reciba	 R e T i b a 
reciben	 R e T i b e n 
recibe	 R e T i b e 
recibidas	 R e T i b i d a s 
recibido	 R e T i b i d o 
recibidos	 R e T i b i d o s 
recibiendo	 R e T i b i e n d o 
recibieron	 R e T i b i e r o n 
recibiria	 R e T i b i r i a 
recibir	 R e T i b i r 
reciclar	 R e T i k l a r 
recientemente	 R e T i e n t e m e n t e 
reciente	 R e T i e n t e 
recientes	 R e T i e n t e s 
reclutabamos	 R e k l u t a b a m o s 
reclutamiento	 R e k l u t a m i e n t o 
reclutar	 R e k l u t a r 
recogen	 R e k o x e n 
recoge	 R e k o x e 
recogida	 R e k o x i d a 
recogidas	 R e k o x i d a s 
recogido	 R e k o x i d o 
recogidos	 R e k o x i d o s 
recojan	 R e k o x a n 
recoleccion	 R e k o l e k T i o n 
recolectar	 R e k o l e k t a r 
recomendaria	 R e k o m e n d a r i a 
recomiendo	 R e k o m i e n d o 
reconocedores	 R e k o n o T e d o r e s 
reconocemos	 R e k o n o T e m o s 
reconoce	 R e k o n o T e 
reconocerlo	 R e k o n o T e r l o 
reconocer	 R e k o n o T e r 
reconocidas	 R e k o n o T i d a s 
reconocidos	 R e k o n o T i d o s 
reconociendo	 R e k o n o T i e n d o 
reconocimiento	 R e k o n o T i m i e n t o 
recopila	 R e k o p i l a 
recordaba	 R e k o r d a b a 
recordara	 R e k o r d a r a 
recordar	 R e k o r d a r 
recorre	 R e k o R e 
recorrer	 R e k o R e r 
recorrido	 R e k o R i d o 
recreaciones	 R e k r e a T i o n e s 
rectangulos	R e k t a n g u l o s
rectangulos	 R e k t a n g u l o s 
recuerdo	 R e k u e r d o 
recuperacion	R e k u p e r a T i o n	
recuperacion	 R e k u p e r a T i o n 
recuperados	 R e k u p e r a d o s 
recuperan	 R e k u p e r a n 
recupera	 R e k u p e r a 
recuperarla	 R e k u p e r a r l a 
recuperar	 R e k u p e r a r 
recurrentemente	 R e k u R e n t e m e n t e 
recurrente	 R e k u R e n t e 
recurrimos	 R e k u R i m o s 
recurrir	 R e k u R i r 
recurso	 R e k u r s o 
recursos	 R e k u r s o s 
redes	 R e d e s 
redirecciona	 R e d i r e k T i o n a 
redonda	 R e d o n d a 
redondas	 R e d o n d a s 
red	 R e d 
reducia	 R e d u T i a 
reducido	 R e d u T i d o 
reducir	 R e d u T i r 
reestructuracion	 R e e s t r u k t u r a T i o n 
referencia	 R e f e r e n T i a 
referente	 R e f e r e n t e 
referia	 R e f e r i a 
refieran	 R e f i e r a n 
refieren	 R e f i e r e n 
refiero	 R e f i e r o 
refinamiento	 R e f i n a m i e n t o 
refinar	 R e f i n a r 
refinas	 R e f i n a s 
refiriendo	 R e f i r i e n d o 
reflejadas	 R e f l e x a d a s 
reflejan	 R e f l e x a n 
refleja	 R e f l e x a 
reflejar	 R e f l e x a r 
reflexiones	 R e f l e k s i o n e s 
reformulacion	 R e f o r m u l a T i o n 
reformular	 R e f o r m u l a r 
regalara	 R e g a l a r a 
regionales	 R e x i o n a l e s 
regional	 R e x i o n a l 
regiones	 R e x i o n e s 
region	 R e x i o n 
region	 R i g i o n 
registrado	 R e x i s t r a d o 
registrados	 R e x i s t r a d o s 
registraran	 R e x i s t r a r a n 
registrarlo	 R e x i s t r a r l o 
registro	 R e x i s t r o 
registros	 R e x i s t r o s 
regla	 R e g l a 
reglas	 R e g l a s 
regresan	 R e g r e s a n 
regresan	R e g r e s a n
regresa	 R e g r e s a 
regresar	 R e g r e s a r 
regresion	 R e g r e s i o n 
regulacion	 R e g u l a T i o n 
regulado	 R e g u l a d o 
regularidad	 R e g u l a r i d a d 
regularizacion	 R e g u l a r i T a T i o n 
regularmente	 R e g u l a r m e n t e 
regular	 R e g u l a r 
regular	R e g u l a r
rehacerlo	 R e a T e r l o 
reino	 R e i n o 
reis	 R e i s 
relacionadas	 R e l a T i o n a d a s 
relacionado	 R e l a T i o n a d o 
relacionados	 R e l a T i o n a d o s 
relaciones	 R e l a T i o n e s 
relacion	R e l a T i o n
relacion	 R e l a T i o n 
relativamente	 R e l a t i b a m e n t e 
relativa	 R e l a t i b a 
relativas	 R e l a t i b a s 
relativo	 R e l a t i b o 
relevance	R e l e b a n s
relevancia	 R e l e b a n T i a 
relevante	 R e l e b a n t e 
relevantes	 R e l e b a n t e s 
relevant	R e l e b a n t
rellenaba	 R e y e n a b a 
rellenar	 R e y e n a r 
relleno	 R e y e n o 
remedio	 R e m e d i o 
remota	 R e m o t a 
remotos	 R e m o t o s 
rencor	 R e n k o r 
rendia	 R e n d i a 
rendimiento	 R e n d i m i e n t o 
renfe	 R e n f e 
renovando	 R e n o b a n d o 
renovara	 R e n o b a r a 
rentabilidad	 R e n t a b i l i d a d 
rentable	 R e n t a b l e 
renunciar	 R e n u n T i a r 
reorganizacion	 R e o r g a n i T a T i o n 
reorientamos	 R e o r i e n t a m o s 
repartidos	 R e p a r t i d o s 
reparto	 R e p a r t o 
repasar	 R e p a s a r 
repaso	 R e p a s o 
repente	 R e p e n t e 
repeticion	R e p e t i T i o n
repeticion	 R e p e t i T i o n 
repetimos	 R e p e t i m o s 
repetir	 R e p e t i r 
repita	 R e p i t a 
repiten	 R e p i t e n 
repiten	R e p i t e n
repite	 R e p i t e 
replantear	 R e p l a n t e a r 
repositorio	 R e p o s i t o r i o 
repositorios	 R e p o s i t o r i o s 
repositor	 R e p o s i t o r 
representaba	 R e p r e s e n t a b a 
representacion	R e p r e s e n t a T i o n
representacion	 R e p r e s e n t a T i o n 
representados	 R e p r e s e n t a d o s 
representando	 R e p r e s e n t a n d o 
representante	 R e p r e s e n t a n t e 
representa	 R e p r e s e n t a 
representar	 R e p r e s e n t a r 
representatividad	 R e p r e s e n t a t i b i d a d 
representativo	 R e p r e s e n t a t i b o 
represento	 R e p r e s e n t o 
reproductor	 R e p r o d u k t o r 
repsol	 R e p s o l 
requerida	 R e k e r i d a 
requeriria	 R e k e r i r i a 
requerir	 R e k e r i r 
requiere	 R e k i e r e 
requisitos	 R e k i s i t o s 
reservadas	 R e s e r b a d a s 
reservado	 R e s e r b a d o 
resetear	 R e s e t e a r 
residencia	 R e s i d e n T i a 
resistencias	 R e s i s t e n T i a s 
resistir	 R e s i s t i r 
resoluciones	 R e s o l u T i o n e s 
resolucion	R e s o l u T i o n
resolucion	 R e s o l u T i o n 
resolverla	 R e s o l b e r l a 
resolverlo	 R e s o l b e r l o 
resolverosla	 R e s o l b e r o s l a 
resolver	 R e s o l b e r 
resolverselo	 R e s o l b e r s e l o 
resolviendo	 R e s o l b i e n d o 
respaldar	 R e s p a l d a r 
respaldo	 R e s p a l d o 
respectaba	 R e s p e k t a b a 
respecta	 R e s p e k t a 
respecto	 R e s p e k t o 
respetan	 R e s p e t a n 
respetos	 R e s p e t o s 
responda	 R e s p o n d a 
respondedor	 R e s p o n d e d o r 
responde	 R e s p o n d e 
responder	 R e s p o n d e r 
respondido	 R e s p o n d i d o 
respondiendo	 R e s p o n d i e n d o 
responsabilidad	 R e s p o n s a b i l i d a d 
respuesta	 R e s p u e s t a 
respuestas	 R e s p u e s t a s 
restaurantes	 R e s t a u r a n t e s 
resto	 R e s t o 
restriccion	 R e s t r i k T i o n 
restringido	 R e s t r i n x i d o 
resuelto	 R e s u e l t o 
resuelven	 R e s u e l b e n 
resuelve	 R e s u e l b e 
resuelvo	 R e s u e l b o 
resuerve	 R e s u e r b e 
resultaban	 R e s u l t a b a n 
resultaba	 R e s u l t a b a 
resultado	 R e s u l t a d o 
resultados	 R e s u l t a d o s 
resulta	 R e s u l t a 
resultar	 R e s u l t a r 
resulte	 R e s u l t e 
resumenes	 R e s u m e n e s 
resumen	 R e s u m e n 
resumir	 R e s u m i r 
retirada	 R e t i r a d a 
retomar	 R e t o m a r 
reto	 R e t o 
retos	 R e t o s 
retrasada	 R e t r a s a d a 
retraso	 R e t r a s o 
retrieval	R e t r i b a l
retroalimentacion	 R e t r o a l i m e n t a T i o n 
reunido	 R e u n i d o 
reunimos	 R e u n i m o s 
reuniones	 R e u n i o n e s 
reunion	 R e u n i o n 
reutilizable	 R e u t i l i T a b l e 
review	R e b i u
revisada	 R e b i s a d a 
revisadas	 R e b i s a d a s 
revisado	 R e b i s a d o 
revisar	 R e b i s a r 
revision	 R e b i s i o n 
revisores	 R e b i s o r e s 
revista	 R e b i s t a 
revistas	 R e b i s t a s 
reyes	 R e y e s 
ricardo	 R i k a r d o 
rica	 R i k a 
ricas	 R i k a s 
rico	 R i k o 
ricos	 R i k o s 
riesgo	 R i e s g o 
riguroso	 R i g u r o s o 
rigurosos	 R i g u r o s o s 
rinden	 R i n d e n 
rindes	 R i n d e s 
rindo	 R i n d o 
rioja	 R i o x a 
rio	 R i o 
ritmo	 R i t m o 
ritmos	 R i t m o s 
road	R o u d
roads	R o u d s
robot	 R o b o t 
robots	 R o b o t s 
robusto	 R o b u s t o 
robustos	 R o b u s t o s 
rodean	 R o d e a n 
rodrigo	 R o d r i g o 
roja	 R o x a 
rojas	 R o x a s 
rojo	 R o x o 
rolling	 R o u l i n 
rompa	 R o m p a 
rompiendo	 R o m p i e n d o 
rosa	 R o s a 
rotando	 R o t a n d o 
rotondas	 R o t o n d a s 
roto	 R o t o 
rotos	 R o t o s 
rotulo	 R o t u l o 
rozas	 R o T a s 
rssatom	e R e e s e e s e a t o m
rss	e R e e s e e s e
rte	e R e t e e
rueda	 R u e d a 
ruido	 R u i d o 
ruidosas	 R u i d o s a s 
run	R a n
ruptura	 R u p t u r a 
ruta	 R u t a 
sabeis	 s a b e i s 
sabemos	 s a b e m o s 
saben	 s a b e n 
saber	 s a b e r 
sabe	 s a b e 
sabe	s a b e
sabes	 s a b e s 
sabiamos	 s a b i a m o s 
sabian	 s a b i a n 
sabia	 s a b i a 
sabido	 s a b i d o 
sabiendo	 s a b i e n d o 
sacabamos	s a k a b a m o s
sacabamos	 s a k a b a m o s 
sacada	 s a k a d a 
sacado	 s a k a d o 
sacad	 s a k a d 
sacamos	 s a k a m o s 
sacando	 s a k a n d o 
sacan	 s a k a n 
sacaremos	 s a k a r e m o s 
sacarla	 s a k a r l a 
sacarle	 s a k a r l e 
sacarle	s a k a r l e
sacarlo	 s a k a r l o 
sacar	 s a k a r 
saco	 s a k o 
saco	 s a k o 
sacrificarse	 s a k r i f i k a r s e 
sacrificio	 s a k r i f i T i o 
sa	e s e a
saint	s e i n t
salamanca	 s a l a m a n k a 
salarios	 s a l a r i o s 
salas	 s a l a s 
saldra	 s a l d r a 
salen	 s a l e n 
sale	 s a l e 
salga	 s a l g a 
salian	 s a l i a n 
salida	 s a l i d a 
salido	 s a l i d o 
salientes	 s a l i e n t e s 
salio	 s a l i o 
salio	 s a l i o 
salir	 s a l i r 
salsa	 s a l s a 
saltaba	 s a l t a b a 
saltado	 s a l t a d o 
saltar	 s a l t a r 
salta	 s a l t a 
saltes	 s a l t e s 
saltito	 s a l t i t o 
salto	 s a l t o 
saltos	 s a l t o s 
salud	 s a l u d 
salvo	 s a l b o 
sanchez	 s a n C e T 
sanitaria	 s a n i t a r i a 
san	 s a n 
santiago	 s a n t i a g o 
sarkozy	 s a r k o s i 
satelites	 s a t e l i t e s 
satisfaccion	 s a t i s f a k T i o n 
satisfecho	 s a t i s f e C o 
saturado	 s a t u r a d o 
save	s e i f
scholar	e s k o l a r
screen	e s k r i n
screw	e s k r i u
sdk	e s e d e k a
seais	 s e a i s 
seal	s i l
seals	s i l s
seamos	 s e a m o s 
sean	 s e a n 
search	s e r C
sea	 s e a 
secciones	 s e k T i o n e s 
seccion	 s e k T i o n 
secretaria	 s e k r e t a r i a 
secreto	 s e k r e t o 
sectores	 s e k t o r e s 
sector	 s e k t o r 
secuencias	 s e k u e n T i a s 
secundariamente	 s e k u n d a r i a m e n t e 
secundaria	 s e k u n d a r i a 
secundario	 s e k u n d a r i o 
secundarios	 s e k u n d a r i o s 
security	s e k i u r i t i
sede	 s e d e 
sedes	 s e d e s 
segmentacion	s e g m e n t a T i o n
segmentacion	 s e g m e n t a T i o n 
segmentadas	 s e g m e n t a d a s 
segmentarla	 s e g m e n t a r l a 
segmentarla	s e g m e n t a r l a
segmentar	 s e g m e n t a r 
segmento	s e g m e n t o
segmento	 s e g m e n t o 
segmentos	 s e g m e n t o s 
seguiamos	 s e g i a m o s 
seguia	 s e g i a 
seguido	 s e g i d o 
seguimiento	 s e g i m i e n t o 
seguimos	 s e g i m o s 
seguir	 s e g i r 
segunda	 s e g u n d a 
segundo	 s e g u n d o 
segundos	 s e g u n d o s 
segun	 s e g u n 
seguramente	 s e g u r a m e n t e 
seguridad	 s e g u r i d a d 
seguro	 s e g u r o 
seguros	 s e g u r o s 
seiscientas	 s e i s T i e n t a s 
seiscientos	 s e i s T i e n t o s 
seis	 s e i s 
seis	s e i s
seleccionadas	 s e l e k T i o n a d a s 
seleccionar	 s e l e k T i o n a r 
selecciona	 s e l e k T i o n a 
seleccion	 s e l e k T i o n 
sellos	 s e y o s 
semana	 s e m a n a 
semanas	 s e m a n a s 
semanticamente	s e m a n t i k a m e n t e
semanticamente	 s e m a n t i k a m e n t e 
semantica	s e m a n t i k a
semantica	 s e m a n t i k a 
semanticas	 s e m a n t i k a s 
semantico	s e m a n t i k o
semantico	 s e m a n t i k o 
semanticos	 s e m a n t i k o s 
semantic	s e m a n t i k
semejante	 s e m e x a n t e 
semejantes	 s e m e x a n t e s 
semiautomatica	 s e m i a u t o m a t i k a 
semiestructurada	 s e m i e s t r u k t u r a d a 
semiestructurado	 s e m i e s t r u k t u r a d o 
seminario	 s e m i n a r i o 
señalado	 s e N a l a d o 
señalando	 s e N a l a n d o 
señalar	 s e N a l a r 
señalo	 s e N a l o 
señal	 s e N a l 
sencillamente	 s e n T i y a m e n t e 
sencilla	 s e n T i y a 
sencillas	 s e n T i y a s 
sencillisimo	 s e n T i y i s i m o 
sencillo	 s e n T i y o 
sencillos	 s e n T i y o s 
señores	 s e N o r e s 
señor	 s e N o r 
sensibilidad	 s e n s i b i l i d a d 
sensible	 s e n s i b l e 
sentabamos	 s e n t a b a m o s 
sentaban	 s e n t a b a n 
sentado	 s e n t a d o 
sentamos	 s e n t a m o s 
sentarte	 s e n t a r t e 
sentido	 s e n t i d o 
sentidos	 s e n t i d o s 
sentimiento	 s e n t i m i e n t o 
seo	 s e o 
sepais	 s e p a i s 
sepamos	 s e p a m o s 
separacion	 s e p a r a T i o n 
separada	 s e p a r a d a 
separando	 s e p a r a n d o 
separar	 s e p a r a r 
sepa	 s e p a 
septiembre	 s e p t i e m b r e 
sera	 s e r a 
serbia	 s e r b i a 
seremos	 s e r e m o s 
seres	 s e r e s 
seres	s e r e s
seria	s e r i a
seria	 s e r i a 
serie	 s e r i e 
serio	 s e r i o 
serios	 s e r i o s 
serrano	 s e R a n o 
ser	 s e r 
servicio	 s e r b i T i o 
servicios	 s e r b i T i o s 
servidores	 s e r b i d o r e s 
servidor	 s e r b i d o r 
serviran	 s e r b i r a n 
servira	 s e r b i r a 
servirnos	 s e r b i r n o s 
servir	 s e r b i r 
s	e s
se	 s e 
se	s e
se	 s e 
sesenta	 s e s e n t a 
sesgo	 s e s g o 
sesgos	 s e s g o s 
sesiones	 s e s i o n e s 
sesion	 s e s i o n 
setecientos	 s e t e T i e n t o s 
setenta	 s e t e n t a 
sevilla	 s e b i y a 
sexo	 s e k s o 
sgae	e s e g a e
ship	s i p
show	 s o u 
sido	 s i d o 
siempre	 s i e m p r e 
siendo	 s i e n d o 
sientan	 s i e n t a n 
sientas	 s i e n t a s 
siente	 s i e n t e 
siete	 s i e t e 
sigamos	 s i g a m o s 
siglo	 s i g l o 
significaba	 s i g n i f i k a b a 
significacion	 s i g n i f i k a T i o n 
significado	 s i g n i f i k a d o 
significan	 s i g n i f i k a n 
significar	 s i g n i f i k a r 
significa	 s i g n i f i k a 
significativamente	 s i g n i f i k a t i b a m e n t e 
significativa	 s i g n i f i k a t i b a 
significativas	 s i g n i f i k a t i b a s 
significativo	 s i g n i f i k a t i b o 
signifique	 s i g n i f i k e 
siguen	 s i g e n 
sigue	 s i g e 
siguiendo	 s i g i e n d o 
siguiente	 s i g i e n t e 
siguientes	 s i g i e n t e s 
siguiera	 s i g i e r a 
siguieron	 s i g i e r o n 
silencio	 s i l e n T i o 
similares	 s i m i l a r e s 
similar	 s i m i l a r 
similitud	 s i m i l i t u d 
simplemente	 s i m p l e m e n t e 
simplemente	s i m p l e m e n t e
simple	 s i m p l e 
simples	 s i m p l e s 
simplificando	 s i m p l i f i k a n d o 
simplificar	 s i m p l i f i k a r 
simpson	 s i m s o n 
simultaneamente	 s i m u l t a n e a m e n t e 
simultanea	 s i m u l t a n e a 
sinamed	 s i n a m e d 
sinceramente	 s i n T e r a m e n t e 
sinergias	 s i n e r x i a s 
singulares	 s i n g u l a r e s 
singular	 s i n g u l a r 
sinonimo	s i n o n i m o
sinonimo	 s i n o n i m o 
sinonimos	s i n o n i m o s
sinonimos	 s i n o n i m o s 
sino	 s i n o 
sino	s i n o
sin	 s i n 
sintactica	 s i n t a k t i k a 
sintaxis	 s i n t a k s i s 
sintesis	 s i n t e s i s 
siquiera	 s i k i e r a 
sirva	 s i r b a 
sirven	 s i r b e n 
sirve	 s i r b e 
si	 s i 
si	s i
si	 s i 
sistema	 s i s t e m a 
sistemas	 s i s t e m a s 
sistematicamente	 s i s t e m a t i k a m e n t e 
sistematicas	 s i s t e m a t i k a s 
site	 s a i t
sitio	 s i t i o 
sitios	 s i t i o s 
situaciones	 s i t u a T i o n e s 
situacion	 s i t u a T i o n 
situado	 s i t u a d o 
situar	 s i t u a r 
situa	 s i t u a 
skip	e s k i p
sky	e s k a i
skype	 e s k a i p 
sl	e s e e l e
sms	e s e e m e e T e
snippet	e s n i p e t
snomed	e s n o m d
sobreajuste	 s o b r e a x u s t e 
sobrepasarlo	 s o b r e p a s a r l o 
sobre	 s o b r e 
sobrevive	 s o b r e b i b e 
sociales	 s o T i a l e s 
socialmente	 s o T i a l m e n t e 
social	 s o T i a l 
sociedades	 s o T i e d a d e s 
sociedad	 s o T i e d a d 
sociocultural	 s o T i o k u l t u r a l 
socio	 s o T i o 
sofisticadas	 s o f i s t i k a d a s 
sofisticado	 s o f i s t i k a d o 
software	 s o f g u e a r
sois	 s o i s 
solamente	 s o l a m e n t e 
solapamiento	 s o l a p a m i e n t o 
solares	 s o l a r e s 
sola	 s o l a 
solemos	 s o l e m o s 
solicitada	 s o l i T i t a d a 
solicitan	 s o l i T i t a n 
solicita	 s o l i T i t a 
solida	 s o l i d a 
solo	 s o l o 
solo	 s o l o 
solos	 s o l o s 
sol	 s o l 
solucionado	 s o l u T i o n a d o 
solucionarlo	 s o l u T i o n a r l o 
solucionar	 s o l u T i o n a r 
soluciones	 s o l u T i o n e s 
solucion	s o l u T i o n
solucion	 s o l u T i o n 
sombra	 s o m b r a 
someter	 s o m e t e r 
sometidos	 s o m e t i d o s 
somos	 s o m o s 
sonar	 s o n a r 
sonido	 s o n i d o 
sonido	s o n i d o
sonologia	 s o n o l o x i a 
son	 s o n 
sopa	 s o p a 
soportada	 s o p o r t a d a 
soportadas	 s o p o r t a d a s 
soportado	 s o p o r t a d o 
soportar	 s o p o r t a r 
soporta	 s o p o r t a 
soporte	 s o p o r t e 
sorprendente	 s o r p r e n d e n t e 
sorprender	 s o r p r e n d e r 
sorprender	s o r p r e n d e r
sorprende	 s o r p r e n d e 
sorprendio	 s o r p r e n d i o 
sorpresa	 s o r p r e s a 
sostengo	 s o s t e n g o 
soulseek	 s o u l s i k 
soy	 s o i 
spain	e s p e i n
spam	 e s p a m 
speed	e s p i d
spin-off	 e s p i n o f 
spinoff	e s p i n o f
spot	e s p o t
stanford	 e s t a n f o r 
stem	e s t e m
stemmers	e s t e m e r s
stones	 e s t o n s 
straight	e s t r e i t
strathclyde	e s t r a d k l a i d
strauss	 e s t r a u s 
study	e s t a d i
subasta	 s u b a s t a 
subconjunto	 s u b k o n x u n t o 
subdirectorios	 s u b d i r e k t o r i o s 
subdominios	 s u b d o m i n i o s 
subdominio	 s u b d o m i n i o 
sube	 s u b e 
subida	 s u b i d a 
subiendo	 s u b i e n d o 
subirlas	 s u b i r l a s 
subjetiva	 s u b x e t i b a 
submision	s u b m i s i o n
submision	 s u b m i s i o n 
subrayar	 s u b r a y a r 
subsanado	 s u b s a n a d o 
subtitulos	s u b t i t u l o s
subtitulos	 s u b t i t u l o s 
subunidades	 s u b u n i d a d e s 
subvencionados	 s u b b e n T i o n a d o s 
subvencionado	 s u b b e n T i o n a d o 
subvencionando	 s u b b e n T i o n a n d o 
subvenciones	 s u b b e n T i o n e s 
sucios	 s u T i o s 
sudamerica	 s u d a m e r i k a 
sudando	 s u d a n d o 
sudan	 s u d a n 
suecia	 s u e T i a 
suecos	 s u e k o s 
sueco	 s u e k o 
suegra	 s u e g r a 
sueldos	 s u e l d o s 
sueldo	 s u e l d o 
suelen	 s u e l e n 
suele	 s u e l e 
sueltas	 s u e l t a s 
suena	 s u e n a 
suerte	 s u e r t e 
suficientemente	 s u f i T i e n t e m e n t e 
suficientes	 s u f i T i e n t e s 
suficiente	 s u f i T i e n t e 
sufre	 s u f r e 
sugerencias	 s u x e r e n T i a s 
sugiere	 s u x i e r e 
sugirais	 s u x i r a i s 
suite	 s u i t 
sujetos	 s u x e t o s 
suma	 s u m a 
suministran	 s u m i n i s t r a n 
superarlo	 s u p e r a r l o 
superar	 s u p e r a r 
supera	 s u p e r a 
supere	 s u p e r e 
superficies	 s u p e r f i T i e s 
superiores	 s u p e r i o r e s 
superior	 s u p e r i o r 
supermercados	 s u p e r m e r k a d o s 
supermercados	s u p e r m e r k a d o s
supermercado	 s u p e r m e r k a d o 
supimos	 s u p i m o s 
suponen	 s u p o n e n 
suponer	 s u p o n e r 
supone	 s u p o n e 
supongo	 s u p o n g o 
suponiendo	 s u p o n i e n d o 
supuestamente	 s u p u e s t a m e n t e 
supuesto	 s u p u e s t o 
surge	 s u r x e 
surgido	 s u r x i d o 
surgiendo	 s u r x i e n d o 
surgio	 s u r x i o 
sur	 s u r 
suscripcion	 s u s k r i p T i o n 
sus	 s u s 
sustanciales	 s u s t a n T i a l e s 
sustancialmente	 s u s t a n T i a l m e n t e 
sustancial	 s u s t a n T i a l 
sustituir	 s u s t i t u i r 
sustituyan	 s u s t i t u y a n 
sustituyes	 s u s t i t u y e s 
su	 s u 
su	s u
suv	e s e u b e
suya	 s u y a 
suyos	 s u y o s 
suyo	 s u y o 
svm	e s e u b e e m e
tablas	 t a b l a s 
tabla	 t a b l a 
tactica	 t a k t i k a 
tacto	 t a k t o 
tags	t a g s
taiwan	 t a i g u a n 
tajo	 t a x o 
talento	 t a l e n t o 
taller	 t a y e r 
tal	 t a l 
tamaños	 t a m a N o s 
tamaños	t a m a N o s
tamaño	 t a m a N o 
tambien	t a m b i e n
tambien	 t a m b i e n 
tampoco	 t a m p o k o 
tanques	 t a n k e s 
tan	 t a n 
tantas	 t a n t a s 
tanta	 t a n t a 
tantos	 t a n t o s 
tanto	 t a n t o 
tardado	 t a r d a d o 
tardamos	 t a r d a m o s 
tardas	 t a r d a s 
tardebn	t a r d e b n
tarden	 t a r d e n 
tardes	 t a r d e s 
tarde	 t a r d e 
tareas	 t a r e a s 
tarea	 t a r e a 
tarjeta	 t a r x e t a 
tasa	 t a s a 
taxis	 t a k s i s 
teatro	 t e a t r o 
teclas	 t e k l a s 
tecleada	 t e k l e a d a 
tecnicamente	 t e k n i k a m e n t e 
tecnicas	t e k n i k a s
tecnicas	 t e k n i k a s 
tecnica	t e k n i k a
tecnica	 t e k n i k a 
tecnicos	t e k n i k o s
tecnicos	 t e k n i k o s 
tecnico	 t e k n i k o 
tecnologias	 t e k n o l o x i a s 
tecnologia	 t e k n o l o x i a 
tecnologicamente	 t e k n o l o x i k a m e n t e 
tecnologicas	 t e k n o l o x i k a s 
tecnologica	 t e k n o l o x i k a 
tecnologicos	 t e k n o l o x i k o s 
tecnologico	 t e k n o l o x i k o 
tecnologos	 t e k n o l o g o s 
tejido	 t e x i d o 
tela	 t e l a 
telecom	 t e l e k o m 
telecomunicaciones	 t e l e k o m u n i k a T i o n e s 
telefonica	t e l e f o n i k a
telefonica	 t e l e f o n i k a 
telefonicos	 t e l e f o n i k o s 
telefonico	 t e l e f o n i k o 
telefonos	t e l e f o n o s
telefonos	 t e l e f o n o s 
telefono	t e l e f o n o
telefono	 t e l e f o n o 
telegate	 t e l e g e i t
television	 t e l e b i s i o n 
televisiva	 t e l e b i s i b a 
teller	t e l e r
temas	 t e m a s 
tema	 t e m a 
tematicas	 t e m a t i k a s 
tematica	 t e m a t i k a 
temes	 t e m e s 
temor	 t e m o r 
temo	 t e m o 
temporales	 t e m p o r a l e s 
temporal	 t e m p o r a l 
tendencias	 t e n d e n T i a s 
tendencia	 t e n d e n T i a 
tendia	 t e n d i a 
tendra	 t e n d r a 
tendremos	 t e n d r e m o s 
tendre	 t e n d r e 
tendriamos	 t e n d r i a m o s 
tendrian	 t e n d r i a n 
tendria	 t e n d r i a 
teneis	 t e n e i s 
tenemos	 t e n e m o s 
tenerla	 t e n e r l a 
tenerlo	 t e n e r l o 
tener	 t e n e r 
tengais	 t e n g a i s 
tengamos	 t e n g a m o s 
tengan	 t e n g a n 
tengas	 t e n g a s 
tenga	 t e n g a 
tengo	 t e n g o 
teniamos	t e n i a m o s
teniamos	 t e n i a m o s 
tenian	t e n i a n
tenian	 t e n i a n 
tenias	 t e n i a s 
tenia	t e n i a
tenia	 t e n i a 
tenido	 t e n i d o 
teniendo	 t e n i e n d o 
tensiones	 t e n s i o n e s 
tension	 t e n s i o n 
teorias	 t e o r i a s 
teoria	 t e o r i a 
teorico	 t e o r i k o 
terceras	 t e r T e r a s 
tercera	 t e r T e r a 
terceros	 t e r T e r o s 
tercero	 t e r T e r o 
tercer	 t e r T e r 
tercio	 t e r T i o 
terminacion	 t e r m i n a T i o n 
terminado	 t e r m i n a d o 
terminando	 t e r m i n a n d o 
terminare	 t e r m i n a r e 
terminaria	 t e r m i n a r i a 
terminar	 t e r m i n a r 
terminologia	 t e r m i n o l o x i a 
terminologico	 t e r m i n o l o x i k o 
terminos	 t e r m i n o s 
terminos	 t e r m i n o s 
termino	 t e r m i n o 
termino	 t e r m i n o 
terreno	 t e R e n o 
terrible	 t e R i b l e 
territorio	 t e R i t o r i o 
tesauro	 t e s a u r o 
tesis	 t e s i s 
tests	 t e s 
tests	t e s t s
test	 t e s 
te	 t e 
te	t e
textbased	t e k s t b e i s d	
textos	 t e k s t o s 
textos	t e k s t o s
texto	 t e k s t o 
text	t e k s t
textuales	 t e k s t u a l e s 
textual	 t e k s t u a l 
textura	 t e k s t u r a 
that	d a t
the	d e
thera	 t e r a 
things	T i n g s
tic	 t i k 
tiempo	 t i e m p o 
tiendas	 t i e n d a s 
tienen	 t i e n e n 
tienen	t i e n e n
tienes	 t i e n e s 
tiene	 t i e n e 
tien	t i e n
tierra	 t i e R a 
tinta	 t i n t a 
tios	 t i o s 
tio	 t i o 
tipicas	 t i p i k a s 
tipica	t i p i k a
tipica	 t i p i k a 
tipico	t i p i k o
tipico	 t i p i k o 
tipos	t i p o
tipos	 t i p o s 
tipo	 t i p o 
tiraron	 t i r a r o n 
tirar	 t i r a r 
tiras	 t i r a s 
tires	 t i r e s 
ti	 t i 
titulados	 t i t u l a d o s 
titulos	 t i t u l o s 
titulo	t i t u l o
titulo	 t i t u l o 
tocar	 t o k a r 
toca	 t o k a 
todas	 t o d a s 
todas	t o d a s
toda	 t o d a 
todavia	t o d a b i a
todavia	 t o d a b i a 
todos	 t o d o s 
todos	t o d o s
todo	 t o d o 
tomabamos	 t o m a b a m o s 
tomadas	 t o m a d a s 
tomamos	 t o m a m o s 
tomando	 t o m a n d o 
tomara	 t o m a r a 
tomar	 t o m a r 
tomar	t o m a r
toma	 t o m a 
tonta	 t o n t a 
tonterias	 t o n t e r i a s 
tonteria	 t o n t e r i a 
tonto	 t o n t o 
topa	 t o p a 
topics	t o p i k s
topic	t o p i k
top	 t o p 
toqueis	 t o k e i s 
torno	 t o r n o 
torpes	 t o r p e s 
torponas	 t o r p o n a s 
torrejon	 t o R e x o n 
torres	 t o R e s 
toshiba	 t o s i b a 
totalmente	 t o t a l m e n t e 
total	 t o t a l 
to	t u
tpi	t e p e i
tp	t e p e
trabajaban	 t r a b a x a b a n 
trabajaba	 t r a b a x a b a 
trabajadores	 t r a b a x a d o r e s 
trabajado	 t r a b a x a d o 
trabajamos	 t r a b a x a m o s 
trabajando	 t r a b a x a n d o 
trabajando	t r a b a x a n d o
trabajan	 t r a b a x a n 
trabajaramos	 t r a b a x a r a m o s 
trabajarlo	 t r a b a x a r l o 
trabajar	 t r a b a x a r 
trabajas	 t r a b a x a s 
trabaja	 t r a b a x a 
trabaja	t r a b a x a
trabajen	 t r a b a x e n 
trabaje	 t r a b a x e 
trabajoso	 t r a b a x o s o 
trabajos	 t r a b a x o s 
trabajos	t r b a x o s
trabajo	 t r a b a x o 
trabas	 t r a b a s 
tradicionalmente	 t r a d i T i o n a l m e n t e 
tradicional	 t r a d i T i o n a l 
tradicion	 t r a d i T i o n 
traducciones	 t r a d u k T i o n e s 
traduccion	t r a d u k T i o n
traduccion	 t r a d u k T i o n 
traduces	 t r a d u T e s 
traduce	 t r a d u T e 
traducido	 t r a d u T i d o 
traducir	 t r a d u T i r 
traductores	 t r a d u k t o r e s 
traductor	 t r a d u k t o r 
traen	 t r a e n 
traer	 t r a e r 
trae	 t r a e 
trafico	 t r a f i k o 
tramite	 t r a m i t e 
trampas	 t r a m p a s 
trampa	 t r a m p a 
tramposo	 t r a m p o s o 
transferencia	 t r a n s f e r e n T i a 
transferido	 t r a n s f e r i d o 
transferirlas	 t r a n s f e r i r l a s 
transferir	 t r a n s f e r i r 
transfiriendo	 t r a n s f i r i e n d o 
transformabamos	 t r a n s f o r m a b a m o s 
transformabamos	t r a n s f r o r m a b a m o s
transformacion	 t r a n s f o r m a T i o n 
transformando	 t r a n s f o r m a n d o 
transformar	 t r a n s f o r m a r 
transgenicos	 t r a n s x e n i k o s 
transicion	 t r a n s i T i o n 
translingüe	 t r a n s l i n g u e 
transmisible	 t r a n s m i s i b l e 
transmite	 t r a n s m i t e 
transmitiros	 t r a n s m i t i r o s 
transmitir	 t r a n s m i t i r 
transparencias	 t r a n s p a r e n T i a s 
transparencia	 t r a n s p a r e n T i a 
trascendia	 t r a s T e n d i a 
trascripcion	t r a n s k r i p T i o n
trascripcion	 t r a s k r i p T i o n 
trasladado	 t r a s l a d a d o 
trasladaron	 t r a s l a d a r o n 
trasladar	 t r a s l a d a r 
traslingüe	 t r a s l i n g u e 
trasnacionales	 t r a s n a T i o n a l e s 
traspaso	 t r a s p a s o 
tras	 t r a s 
tratado	 t r a t a d o 
tratamientos	 t r a t a m i e n t o s 
tratamiento	 t r a t a m i e n t o 
tratamos	 t r a t a m o s 
tratando	 t r a t a n d o 
tratan	 t r a t a n 
tratarlos	 t r a t a r l o s 
tratarlo	 t r a t a r l o 
tratarlo	t r a t a r l o
tratar	 t r a t a r 
trata	 t r a t a 
trata	t r a t a
trate	 t r a t e 
trato	 t r a t o 
traves	 t r a b e s 
trece	 t r e T e 
trec	 t r e k 
trees	t r i s
tree	t r i
trèfle	t r e f e l
treinta	 t r e i n t a 
tremendamente	 t r e m e n d a m e n t e 
tremendo	 t r e m e n d o 
tremento	t r e m e n t o
trescientas	 t r e s T i e n t a s 
trescientos	 t r e s T i e n t o s 
trescientos	t r e s T i e n t o s
tres	 t r e s 
tribunal	 t r i b u n a l 
trigramas	 t r i g r a m a s 
trimestral	 t r i m e s t r a l 
triplicar	 t r i p l i k a r 
triste	 t r i s t e 
triunfado	 t r i u n f a d o 
trivial	 t r i b i a l 
trucos	 t r u k o s 
truco	 t r u k o 
tsystems	t e s i s t e m s
tumores	 t u m o r e s 
tunas	 t u n a s 
turing	 t u r i n s 
turismo	 t u r i s m o 
turistas	 t u r i s t a s 
turistica	 t u r i s t i k a 
tus	 t u s 
tu	 t u 
tu	 t u 
tuviera	 t u b i e r a 
tuvimos	 t u b i m o s 
tuvo	 t u b o 
tuya	 t u y a 
tuyo	 t u y o 
twist	 t u i s 
ubicada	 u b i k a d a 
ubicarte	 u b i k a r t e 
ubicar	 u b i k a r 
ultimas	 u l t i m a s 
ultima	 u l t i m a 
ultimos	u l t i m o s
ultimos	 u l t i m o s 
ultimo	 u l t i m o 
unas	 u n a s 
una	 u n a 
unedes	u n e d e s
uned	 u n e d 
unesco	 u n e s k o 
unicamente	 u n i k a m e n t e 
unica	u n i c a
unica	 u n i k a 
unicos	 u n i k o s 
unico	u n i c o
unico	 u n i k o 
unidades	 u n i d a d e s 
unidad	 u n i d a d 
unidos	 u n i d o s 
unido	 u n i d o 
unificado	 u n i f i k a d o 
uniformemente	 u n i f o r m e m e n t e 
uniformemente	u n i f o r m e m e n t e
uniforme	 u n i f o r m e 
unimos	 u n i m o s 
union	u n i o n
union	 u n i o n 
uni	u n i
universalidad	 u n i b e r s a l i d a d 
universal	 u n i b e r s a l 
universidades	 u n i b e r s i d a d e s 
universidad	 u n i b e r s i d a d 
universitarias	 u n i b e r s i t a r i a s 
universitarias	u n i b e r s i t a r i a s	
universitaria	 u n i b e r s i t a r i a 
universitarios	 u n i b e r s i t a r i o s 
universitario	 u n i b e r s i t a r i o 
universo	 u n i b e r s o 
unos	 u n o s 
unos	u n o s
uno	 u n o 
un	 u n 
un	u n
uoc	u o T e
up	u p e
urinarias	 u r i n a r i a s 
urls	u e R e e l e s
url	u e R e e l e
usabamos	 u s a b a m o s 
usaban	 u s a b a n 
usaba	 u s a b a 
usado	 u s a d o 
usais	 u s a i s 
usamos	 u s a m o s 
usando	 u s a n d o 
usan	 u s a n 
usaran	 u s a r a n 
usarlo	 u s a r l o 
usar	 u s a r 
usas	 u s a s 
usa	 u s a 
usa	u s a
usb	u e s e b e
user	i u s e r
users	i u s e r s
usos	 u s o s 
uso	 u s o 
ustedes	 u s t e d e s 
ustedes	u s t e d e s
usted	 u s t e d 
usuarios	 u s u a r i o s 
usuario	 u s u a r i o 
utiles	 u t i l e s 
utilicenlo	 u t i l i T e n l o 
utilicen	 u t i l i T e n 
utilice	 u t i l i T e 
utilidad	 u t i l i d a d 
utilisimo	 u t i l i s i m o 
utilizabamos	u t i l i T a b a m o s
utilizabamos	 u t i l i T a b a m o s 
utilizaba	 u t i l i T a b a 
utilizable	 u t i l i T a b l e 
utilizacion	u t i l i T a T i o n
utilizacion	 u t i l i T a T i o n 
utilizador	 u t i l i T a d o r 
utilizador	u t i l i T a d o r
utilizado	 u t i l i T a d o 
utilizamos	 u t i l i T a m o s 
utilizando	 u t i l i T a n d o 
utilizando	u t i l i T a n d o
utilizan	 u t i l i T a n 
utilizaremos	 u t i l i T a r e m o s 
utilizaria	u t i l i T a r i a
utilizaria	 u t i l i T a r i a 
utilizarlas	 u t i l i T a r l a s 
utilizarla	 u t i l i T a r l a 
utilizarlo	 u t i l i T a r l o 
utilizarlo	u t i l i T a r l o
utilizar	 u t i l i T a r 
utilizas	 u t i l i T a s 
utiliza	 u t i l i T a 
utilizo	 u t i l i T o 
utilizo	 u t i l i T o 
util	 u t i l 
u	 u 
uve	 u b e 
va	 b a 
va	 b a 
vaca	 b a k a 
vacas	 b a k a s 
vacios	 b a T i o s 
vacunar	 b a k u n a r 
vais	 b a i s 
valderrabanos	 b a l d e R a b a n o s 
vale	 b a l e 
valemos	 b a l e m o s 
valencia	 b a l e n T i a 
valga	 b a l g a 
valia	b a l i a
valia	 b a l i a 
valida	 b a l i d a 
validacion	 b a l i d a T i o n 
validaciones	 b a l i d a T i o n e s 
validado	 b a l i d a d o 
validados	 b a l i d a d o s 
validando	 b a l i d a n d o 
validar	 b a l i d a r 
validation	 b a l i d e i s i o n 
validez	 b a l i d e T 
valioso	 b a l i o s o 
valium	 b a l i u m 
valladolid	 b a y a d o l i d 
valoracion	 b a l o r a T i o n 
valoran	 b a l o r a n 
valorarian	 b a l o r a r i a n 
valor	 b a l o r 
valores	 b a l o r e s 
vamos	 b a m o s 
van	 b a n 
variaban	 b a r i a b a n 
varia	 b a r i a 
variabilidad	 b a r i a b i l i d a d 
variacion	 b a r i a T i o n 
variaciones	 b a r i a T i o n e s 
variadas	 b a r i a d a s 
variante	 b a r i a n t e 
variar	 b a r i a r 
varias	 b a r i a s 
variedad	 b a r i e d a d 
varios	 b a r i o s 
vas	 b a s 
vasca	 b a s k a 
vasco	 b a s k o 
vaya	 b a y a 
vayamos	 b a y a m o s 
vea	 b e a 
veais	 b e a i s 
veamos	 b e a m o s 
veas	 b e a s 
ve	 b e 
ve	b e
veces	 b e T e s 
vecindario	 b e T i n d a r i o 
vecinos	 b e T i n o s 
vector	 b e k t o r 
vectores	 b e k t o r e s 
vectorial	 b e k t o r i a l 
vehiculo	 b e i k u l o 
vehiculos	 b e i k u l o s 
veiamos	 b e i a m o s 
veias	 b e i a s 
veinte	 b e i n t e 
veinticinco	 b e i n t i T i n k o 
veinticuatro	 b e i n t i k u a t r o 
veintidos	 b e i n t i d o s 
veintinueve	 b e i n t i n u e b e 
veintiocho	 b e i n t i o C o 
veintiseis	 b e i n t i s e i s 
veintisiete	 b e i n t i s i e t e 
veintitantos	 b e i n t i t a n t o s 
veintiun	b e i n t i u n
veintiun	 b e i n t i u n 
veintiuno	 b e i n t i u n o 
veis	 b e i s 
veis	b e i s
velocidad	 b e l o T i d a d 
vemos	 b e m o s 
ven	 b e n 
vende	 b e n d e 
vendemos	 b e n d e m o s 
venden	 b e n d e n 
venderan	 b e n d e r a n 
vender	 b e n d e r 
venderla	 b e n d e r l a 
venderle	 b e n d e r l e 
venderles	 b e n d e r l e s 
venderlo	 b e n d e r l o 
venderselo	 b e n d e r s e l o 
vendes	 b e n d e s 
vendia	 b e n d i a 
vendiamos	 b e n d i a m o s 
vendido	 b e n d i d o 
vendiendo	 b e n d i e n d o 
vendiendolo	 b e n d i e n d o l o 
vendiera	 b e n d i e r a 
vendo	 b e n d o 
vendran	 b e n d r a n 
venezuela	 b e n e T u e l a 
venga	 b e n g a 
vengan	 b e n g a n 
vengo	 b e n g o 
venia	 b e n i a 
veniamos	 b e n i a m o s 
venido	 b e n i d o 
venir	 b e n i r 
venta	 b e n t a 
ventaja	 b e n t a x a 
ventajas	 b e n t a x a s 
ventana	 b e n t a n a 
veo	 b e o 
veracidad	 b e r a T i d a d 
veran	b e r a n
veran	 b e r a n 
verano	 b e r a n o 
veras	 b e r a s 
ver	 b e r 
verdad	 b e r d a d 
verdaderas	 b e r d a d e r a s 
verde	 b e r d e 
vereis	 b e r e i s 
veremos	 b e r e m o s 
verity	b e r i t i
verlo	 b e r l o 
version	b e r s i o n
version	 b e r s i o n 
versiones	 b e r s i o n e s 
vertical	 b e r t i k a l 
verticales	 b e r t i k a l e s 
ves	 b e s 
vestido	 b e s t i d o 
vete	 b e t e 
vez	 b e T 
via	 b i a 
viabilidad	 b i a b i l i d a d 
viable	 b i a b l e 
viajar	 b i a x a r 
viajes	 b i a x e s 
vias	b i a s
vias	 b i a s 
vi	 b i 
vicente	 b i T e n t e 
viceversa	 b i T e b e r s a 
victor	 b i k t o r 
vida	 b i d a 
video	 b i d e o 
video	 b i d e o 
vidrios	 b i d r i o s 
vieja	 b i e x a 
viendo	 b i e n d o 
viene	 b i e n e 
vienen	 b i e n e n 
vigilancia	 b i x i l a n T i a 
vigilar	 b i x i l a r 
vigilen	 b i x i l e n 
vigor	 b i g o r 
vimos	 b i m o s 
vinculacion	 b i n k u l a T i o n 
vinculados	 b i n k u l a d o s 
viniera	 b i n i e r a 
vinieron	 b i n i e r o n 
vino	 b i n o 
vio	 b i o 
violencia	 b i o l e n T i a 
violin	 b i o l i n 
virtual	 b i r t u a l 
virtuales	 b i r t u a l e s 
visibilidad	 b i s i b i l i d a d 
visible	 b i s i b l e 
visibles	 b i s i b l e s 
vision	 b i s i o n 
visiones	 b i s i o n e s 
visita	 b i s i t a 
visitada	 b i s i t a d a 
visitadas	 b i s i t a d a s 
visitan	 b i s i t a n 
visitando	 b i s i t a n d o 
visitante	 b i s i t a n t e 
visitantes	 b i s i t a n t e s 
visitar	 b i s i t a r 
visitarnos	 b i s i t a r n o s 
visitas	 b i s i t a s 
visiten	 b i s i t e n 
visito	 b i s i t o 
vista	 b i s t a 
vistas	 b i s t a s 
vistazo	 b i s t a T o 
visto	 b i s t o 
visual	 b i s u a l 
visuales	 b i s u a l e s 
visualizacion	 b i s u a l i T a T i o n 
viva	 b i b a 
vive	 b i b e 
viven	 b i b e n 
vivido	 b i b i d o 
viviendo	 b i b i e n d o 
vivimos	 b i b i m o s 
vivir	 b i b i r 
vivis	 b i b i s 
vocablo	 b o k a b l o 
vocablos	 b o k a b l o s 
vocabulario	 b o k a b u l a r i o 
vocabularios	 b o k a b u l a r i o s 
vocacion	 b o k a T i o n 
volcado	 b o l k a d o 
volcarlas	 b o l k a r l a s 
volcarnos	 b o l k a r n o s 
voltear	 b o l t e a r 
volumen	 b o l u m e n 
volumenes	 b o l u m e n e s 
voluntad	 b o l u n t a d 
voluntariado	 b o l u n t a r i a d o 
voluntarios	 b o l u n t a r i o s 
volvemos	 b o l b e m o s 
volver	 b o l b e r 
volveremos	 b o l b e r e m o s 
volverla	 b o l b e r l a 
volvia	 b o l b i a 
vosotros	 b o s o t r o s 
voto	 b o t o 
voy	 b o i 
voz	 b o T 
vuelta	 b u e l t a 
vueltas	 b u e l t a s 
vuelto	 b u e l t o 
vuelva	 b u e l b a 
vuelvas	 b u e l b a s 
vuelve	 b u e l b e 
vuelven	 b u e l b e n 
vuelvo	 b u e l b o 
vuestra	 b u e s t r a 
vuestras	 b u e s t r a s 
vuestro	 b u e s t r o 
vuestros	 b u e s t r o s 
wap	u a p
water	u o t e r
way	u e i
web	 g u e b
webmaster	 g u e b m a s t e r 
webometras	 g u e b o m e t r a s 
webometria	 g u e b o m e t r i a 
webometrics	 g u e b o m e t r i k s 
webs	 g u e b s 
webtrends	 g u e b t r e n s 
wikipedia	 b i k i p e d i a 
will	u i l
windows	 g u i n d o u s 
wordnet	 g u o r n e t 
wordperfect	 g u o r p e r f e t 
words	u o r d s
workflow	u o r k f l o u
yahoo	 y a x u
yasir	 y a s i r
ya	 y a
yell	 y e l
yendo	 y e n d o 
y	 i 
york	 y o r k 
youtube	 y u t u b 
yo	 y o 
zagreb	 T a g r e b 
zapaterias	 T a p a t e r i a s 
zapateria	 T a p a t e r i a 
zapatos	 T a p a t o s 
zaragoza	 T a r a g o T a 
zona	 T o n a 
zurich	 T u r i C
