accuracy	a k i u r a T i
articulo	a r t i k u l o	
asistencia	a s i s t e n T i a
aks	a k a e T e
alchemist	a l k e m i s t
alltheweb	o l d e g u e b
analysis	a n a l i s i s
animals	a n i m o l s
answer	a n s u e r
answering	a n s u e r i n g
application	a p l i k e i C o n
ars	a e R e e T e
atom	a t o m
autonomy	a u t o n o m i
bag	b a x
baseline	b a T e l i n
bbk	b e b e k a
be	b i
biology	b a i o l o y i
btob	b e t o b
built	b i l t
callcenter	c o l c e n t e r
callcenters	c o l c e n t e r s
cd	T e d e
challenge	C a l e n y
citation	s a i t e i C o n
clickando	k l i k a n d o
cnn	T e e n e e n e
comparais	k o m p a r a i s
crawl	k r o l
crawler	k r o l e r
crawlers	k r o l e r s
cross	k r o s
csic	T e s i k
ct	T e t e
cua	k u a
cybermetrics	T a i b e r m e t r i k s
cytit	T a i t i t
daedalus	d a e d a l u s
data	d e i t a
dataset	d a t a s e t
dedicaarsela	d e d i c a r s e l a	
diccionario	d k T i o n a r i o	
dietterich	d i e t e r i C
director	d i r e k t o r
directory	d i r e k t o r i
dni	d e e n e i
don't	d o n t
ejmeplo	e x e m p l o
endtime	e n d t a i m
espacios	e s p a T i o s
espaciotemporales	e s p a T i o t e m p o r a l e s
espacios	e s p a T i o s
estatua	e s t a t u a
everybody	e b r i b o d i
evil	i b i l
exercise	e k s e r s a i s
fab	f a b
facturaciones	f a k t u r a T i o n e s	
falso	f a l s o
feature	f i C u r
filetype	f a i l t a i p
filter	f i l t e r
flicker	f l i k e r
from	f r o m
fullmetal	f u l m e t a l
gap	g a p
gestion	x e s t i o n
gialle	x i a l
gigablast	x i g a b l a s t
give	g i f
h1	a C e u n o
h2	a C e d o s
hl7	a C e e l e s i e t e
hpux	a C e p u k s
html	a C e t e e m e e l e
http	a C e t e t e p e
ibm	i b e e m e
ibn	i n e e n e
iclef	i T e e l e e f e
id	i d
iii	i i i
imaginais	i m a x i n a i s
index	i n d e k s
invite	i m b a i t
keyword	k i u o r d
keywords	k i u o r d s
killer	k i l e r
la2	e l e a d o s
language	l an g u i C
learning	l e r n i n g	
library	l a i b r e r i
linka	l i n k a
live	l a i f
llenguatge	y e n g u a C
logs	l o g s
long	l o n g s
ma	e m e a
maquina	m a k i n a
master	m a s t e r
matching	m a C i n g
mba	e m b i e i
mbas	e m b i e i s
mining	m a i n i n g
mysql	m s i e T e k u e l e
na	e n e a
naturalmail	n a t u r a l m e i l
ntcs	e n e t e T e s e 
ntsc	e n e t e e s e T e
of	o f
offline	o f l a i n
once	u a n s
ong	o e n e x e
online	o n l a i n
once	o n c e
open	o u p e n
originurlextension	o r i y i n u e R e e l e e k s t e n s i o n
otaedor	o t a e d o r
outsourcing	a u t s o u r s i n g
page	p e i y
pagerank	p e i y r a n k
pagina	p a x i n a	
pago	p a g o
pal	p a l
park	p a r k
pattern	p a t e r n
pdf	p e d e e f e
pdfs	p e d e e f e s
peer	p e e r
pensad	p e n s a d
perspectiva	p e r s p e k t i b a
periodista	p e r i o d i s t a	
php	p e a C e p e
pib	p e i b
player	p l e y e r
plm	p e e l e e m e
postcript	p o s t s k r i p t
posts	p o s t s
postscript	p o s t s k r i p t s
proceso	p r o T e s o	
question	k u e s t i o n
questionanswering	k u e s t i o n a n s u e r i n g
recuperacion	R e k u p e r a T i o n	
relevance	R e l e b a n s
retrieval	R e t r i b a l
review	R e b i u
rss	e R e e T e e T e
rssatom	e R e e T e e T e a t o m
rte	e R e t e e
sa	e T e a
scholar	e s k o l a r
screw	e s k r i u
sdk	e T e d e k a
semantic	s e m a n t i k
sgae	e T e g a e
sl	e T e e l e
sms	e T e e m e e T e
snippet	e s n i p e t
snomed	e s n o m d
spain	e s p e i n
spinoff	e s p i n o f
spot	e s p o t
stem	e s t e m
stemmers	e s t e m e r s
strathclyde	e s t r a d k l a i d
study	e s t a d i
suv	e T e u b e
svm	e T e u b e e m e
tags	t a g s
tardebn	t a r d e b n
that	d a t
the	d e
things	T i n g s
tien	t i e n
to	t u
tp	t e p e
tpi	t e p e i
tremento	t r e m e n t o
tsystems	t e s i s t e m s
unedes	u n e d e s
uni	u n i
universitarias	u n i b e r s i t a r i a s	
uoc	u o T e
up	u p e
url	u e R e e l e
urls	u e R e e l e s
usb	u e T e b e
user	i u T e r
users	i u T e r s
veis	b e i s
verity	b e r i t i
wap	u a p
way	u e i
words	u o r d s
workflow	u o r k f l o u
